addr1_packet_ctrl, addr1_bytes_ctrl, addr1_packet, addr1_bytes, addr1_pkt_len_min, addr1_pkt_len_max, addr1_pkt_len_avg,addr1_pkt_len_var, addr1_pkt_len_mom2, addr2_packet_ctrl, addr2_bytes_ctrl, addr2_packet, addr2_bytes, addr2_pkt_len_min, addr2_pkt_len_max, addr2_pkt_len_avg,addr2_pkt_len_var, addr2_pkt_len_mom2, addra_packet_ctrl, addra_bytes_ctrl, addra_packet, addra_bytes, addra_pkt_len_min, addra_pkt_len_max, addra_pkt_len_avg,addra_pkt_len_var, addra_pkt_len_mom2 
1, 52, 0, 0, 0, 0, 0, 0, 0, 1, 52, 0, 0, 0, 0, 0, 0, 0, 2, 104, 0, 0, 0, 0, 0, 0, 0
0, 0, 0, 0, 0, 0, 0, 0, 0, 0, 0, 0, 0, 0, 0, 0, 0, 0, 0, 0, 0, 0, 0, 0, 0, 0, 0
0, 0, 0, 0, 0, 0, 0, 0, 0, 0, 0, 0, 0, 0, 0, 0, 0, 0, 0, 0, 0, 0, 0, 0, 0, 0, 0
0, 0, 0, 0, 0, 0, 0, 0, 0, 0, 0, 0, 0, 0, 0, 0, 0, 0, 0, 0, 0, 0, 0, 0, 0, 0, 0
2, 104, 0, 0, 0, 0, 0, 0, 0, 2, 104, 1, 76, 76, 76, 76.0, 0.0, 5776.0, 4, 208, 1, 76, 76, 76, 76.0, 0.0, 5776.0
15, 780, 7, 3268, 72, 1612, 466.85714285714283, 279129.2653061224, 497084.85714285716, 8, 428, 4, 1120, 83, 707, 280.0, 61897.5, 140297.5, 23, 1208, 11, 4388, 72, 1612, 398.90909090909093, 171962.42666666667, 367344.0
6, 312, 10, 3546, 72, 2110, 354.6, 359040.44000000006, 484781.6, 5, 260, 12, 4801, 107, 1098, 400.0833333333333, 119129.74305555556, 279196.4166666667, 11, 572, 22, 8347, 72, 2110, 379.40909090909093, 190121.20761245678, 372644.2272727273
27, 1428, 29, 8498, 77, 681, 293.0344827586207, 50388.998810939345, 136258.2068965517, 18, 960, 43, 56937, 83, 9768, 1324.1162790697674, 4773936.986479178, 6527220.9069767445, 45, 2388, 72, 65435, 77, 9768, 908.8194444444445, 3783268.7717202264, 3953083.152777778
60, 3160, 45, 13879, 71, 1852, 308.4222222222222, 111880.46617283951, 207004.73333333334, 30, 1592, 75, 157205, 83, 16708, 2096.0666666666666, 18257795.742222227, 22651291.213333335, 90, 4752, 120, 171084, 71, 16708, 1425.7, 14637556.002735045, 14234683.783333333
39, 2068, 32, 9698, 81, 868, 303.0625, 61721.12109375, 153568.0, 22, 1176, 47, 19760, 83, 3381, 420.4255319148936, 354530.28700769576, 531287.914893617, 61, 3244, 79, 29458, 81, 3381, 372.88607594936707, 282775.80725623586, 378287.4430379747
40, 2096, 23, 11327, 73, 1816, 492.4782608695652, 247197.55387523625, 489732.39130434784, 20, 1072, 42, 142139, 83, 22035, 3384.2619047619046, 30415259.62188209, 41868488.26190476, 60, 3168, 65, 153466, 73, 22035, 2361.0153846153844, 25341679.438204214, 27226774.646153845
27, 1436, 15, 6412, 178, 750, 427.46666666666664, 42198.11555555556, 224925.86666666667, 9, 500, 30, 182375, 103, 23220, 6079.166666666667, 37276685.93888888, 74232953.3, 36, 1936, 45, 188787, 103, 23220, 4195.266666666666, 34940462.43662222, 49563610.822222225
155, 8096, 16, 10213, 79, 1568, 638.3125, 153141.46484375, 560584.3125, 2, 104, 337, 3260783, 103, 26116, 9675.913946587538, 49823541.372416764, 143446852.07418397, 157, 8200, 353, 3270996, 79, 26116, 9266.2776203966, 50521833.58871876, 136970420.67422095
18, 944, 5, 2462, 178, 577, 492.4, 24721.44, 267179.2, 5, 284, 14, 71944, 87, 20324, 5138.857142857143, 32999950.69387755, 59407803.428571425, 23, 1228, 19, 74406, 87, 20324, 3916.1052631578946, 30779221.70431589, 43844481.2631579
16, 832, 9, 3419, 178, 767, 379.8888888888889, 50238.32098765432, 194553.88888888888, 1, 60, 18, 150794, 103, 33144, 8377.444444444445, 65338187.58024691, 135519763.0, 17, 892, 27, 154213, 103, 33144, 5711.592592592592, 62514340.90666667, 90411359.96296297
51, 2652, 5, 5465, 576, 1967, 1093.0, 347628.4, 1542277.4, 2, 104, 90, 751723, 103, 23220, 8352.477777777778, 45216055.40506173, 114979940.43333334, 53, 2756, 95, 757188, 103, 23220, 7970.4, 45389224.751029946, 109009537.11578947
28, 1456, 1, 576, 576, 576, 576.0, 0.0, 331776.0, 0, 0, 48, 417004, 1500, 20324, 8687.583333333334, 46326627.03472223, 121800731.20833333, 28, 1456, 49, 417580, 576, 20324, 8522.040816326531, 46520367.54469125, 119321772.93877551
11, 572, 10, 4477, 91, 1258, 447.7, 101279.41, 301714.7, 1, 52, 27, 199511, 87, 23220, 7389.2962962962965, 44828412.13443073, 99430111.8888889, 12, 624, 37, 203988, 87, 23220, 5513.189189189189, 44192412.376708984, 72638653.1891892
3, 156, 7, 1868, 77, 679, 266.85714285714283, 56525.26530612245, 127738.0, 5, 260, 7, 1385, 83, 472, 197.85714285714286, 23022.4081632653, 62169.857142857145, 8, 416, 14, 3253, 77, 679, 232.35714285714286, 35248.02721088434, 94953.92857142857
44, 2296, 11, 5778, 83, 1237, 525.2727272727273, 116253.28925619833, 392164.7272727273, 3, 164, 118, 1025885, 83, 26116, 8693.940677966102, 52737784.97105716, 128322389.48305085, 47, 2460, 129, 1031663, 83, 26116, 7997.387596899225, 53233628.92369978, 117413610.62790698
9, 468, 5, 2017, 91, 577, 403.4, 46287.04, 209018.6, 1, 52, 28, 199382, 83, 17428, 7120.785714285715, 37768929.52551021, 88474518.71428572, 10, 520, 33, 201399, 83, 17428, 6103.0, 38072372.11502284, 75100958.0909091
0, 0, 0, 0, 0, 0, 0, 0, 0, 0, 0, 0, 0, 0, 0, 0, 0, 0, 0, 0, 0, 0, 0, 0, 0, 0, 0
78, 4056, 8, 5363, 575, 1224, 670.375, 45066.734375, 494469.375, 1, 64, 165, 1695963, 537, 23220, 10278.563636363637, 44109821.32473829, 149758691.75151515, 79, 4120, 173, 1701326, 537, 23220, 9834.254335260115, 45200176.583741814, 142856299.9653179
25, 1300, 1, 195, 195, 195, 195.0, 0.0, 38025.0, 0, 0, 27, 250625, 301, 26116, 9282.407407407407, 67620949.79698217, 153784037.07407406, 25, 1300, 28, 250820, 195, 26116, 8957.857142857143, 67865650.73057853, 148293108.07142857
20, 1028, 3, 1728, 576, 576, 576.0, 0.0, 331776.0, 1, 40, 21, 198817, 2948, 20324, 9467.47619047619, 35056771.10657597, 124689876.52380952, 21, 1068, 24, 200545, 576, 20324, 8356.041666666666, 37638839.183209874, 109145113.95833333
20, 1040, 1, 575, 575, 575, 575.0, 0.0, 330625.0, 0, 0, 41, 496036, 1500, 24668, 12098.439024390244, 63954308.09994052, 210326534.92682928, 20, 1040, 42, 496611, 575, 24668, 11824.07142857143, 64764373.92625926, 205326632.30952382
53, 2756, 6, 3465, 195, 785, 577.5, 34514.583333333336, 368020.8333333333, 0, 0, 65, 560576, 87, 23220, 8624.246153846154, 53216157.508639045, 127593779.23076923, 53, 2756, 71, 564041, 87, 23220, 7944.239436619719, 53600504.16906358, 116842306.69014084
11, 572, 3, 1728, 576, 576, 576.0, 0.0, 331776.0, 0, 0, 21, 198439, 1500, 20324, 9449.47619047619, 32652059.10657596, 121944659.38095239, 11, 572, 24, 200167, 576, 20324, 8340.291666666666, 35374544.569876544, 106743048.95833333
0, 0, 0, 0, 0, 0, 0, 0, 0, 0, 0, 0, 0, 0, 0, 0, 0, 0, 0, 0, 0, 0, 0, 0, 0, 0, 0
12, 624, 3, 1725, 575, 575, 575.0, 0.0, 330625.0, 0, 0, 37, 362727, 1015, 18876, 9803.432432432432, 43149152.191380575, 139256439.64864865, 12, 624, 40, 364452, 575, 18876, 9111.3, 44656817.246078596, 128837003.55
6, 312, 3, 1728, 576, 576, 576.0, 0.0, 331776.0, 0, 0, 14, 132927, 1500, 23220, 9494.785714285714, 44415268.02551021, 134566223.7857143, 6, 312, 17, 134655, 576, 23220, 7920.882352941177, 47069938.283038504, 110877791.8235294
6, 312, 5, 2354, 91, 1261, 470.8, 167993.76, 389646.4, 3, 156, 12, 67278, 87, 23220, 5606.5, 54346783.916666664, 85779626.16666667, 9, 468, 17, 69632, 87, 23220, 4096.0, 48769049.274673015, 60664926.23529412
64, 3328, 8, 2698, 87, 576, 337.25, 46122.6875, 159860.25, 5, 260, 163, 1452523, 83, 29012, 8911.184049079755, 52649043.1931198, 132058244.34969325, 69, 3588, 171, 1455221, 83, 29012, 8510.064327485381, 53107693.4886873, 125887559.7134503
9, 468, 2, 668, 91, 577, 334.0, 59049.0, 170605.0, 4, 208, 12, 66670, 76, 18518, 5555.833333333333, 41855799.47222223, 72723083.5, 13, 676, 14, 67338, 76, 18518, 4809.857142857143, 40576821.74556213, 62358443.71428572
8, 416, 2, 1154, 577, 577, 577.0, 0.0, 332929.0, 3, 156, 17, 132947, 77, 17428, 7820.411764705882, 46696627.65397924, 107855467.8235294, 11, 572, 19, 134101, 77, 17428, 7057.9473684210525, 46855269.44444445, 96537305.84210527
68, 3536, 3, 1728, 575, 577, 576.0, 0.6666666666666666, 331776.6666666667, 0, 0, 168, 1530517, 78, 24668, 9110.220238095239, 53842583.50506661, 136838696.29166666, 68, 3536, 171, 1532245, 78, 24668, 8960.497076023392, 54004935.65694694, 134443838.0526316
60, 3120, 1, 577, 577, 577, 577.0, 0.0, 332929.0, 1, 52, 88, 1015600, 704, 23220, 11540.90909090909, 53882659.400826454, 187075242.04545453, 61, 3172, 89, 1016177, 577, 23220, 11417.719101123595, 54253537.96495261, 184977013.80898875
10, 520, 3, 1731, 577, 577, 577.0, 0.0, 332929.0, 1, 52, 20, 198665, 1985, 23220, 9933.25, 36233443.9875, 134902899.55, 11, 572, 23, 200396, 577, 23220, 8712.869565217392, 39386832.52893456, 117350294.69565217
0, 0, 1, 577, 577, 577, 577.0, 0.0, 332929.0, 0, 0, 0, 0, 0, 0, 0, 0, 0, 0, 0, 1, 577, 577, 577, 577.0, 0.0, 332929.0
95, 4940, 2, 1154, 577, 577, 577.0, 0.0, 332929.0, 0, 0, 265, 2743296, 326, 26116, 10352.06037735849, 55496788.90201495, 162661942.95849058, 95, 4940, 267, 2744450, 326, 26116, 10278.838951310861, 55646021.229704894, 161445995.2883895
2, 104, 1, 577, 577, 577, 577.0, 0.0, 332929.0, 0, 0, 7, 66386, 2948, 17428, 9483.714285714286, 33030756.775510203, 122971593.42857143, 2, 104, 8, 66963, 577, 17428, 8370.375, 35764767.795555554, 107641760.375
1, 52, 1, 1132, 1132, 1132, 1132.0, 0.0, 1281424.0, 0, 0, 1, 73, 73, 73, 73.0, 0.0, 5329.0, 1, 52, 2, 1205, 73, 1132, 602.5, 249218.0, 643376.5
1, 52, 0, 0, 0, 0, 0, 0, 0, 0, 0, 1, 576, 576, 576, 576.0, 0.0, 331776.0, 1, 52, 1, 576, 576, 576, 576.0, 0.0, 331776.0
2, 104, 0, 0, 0, 0, 0, 0, 0, 0, 0, 2, 376, 83, 293, 188.0, 11025.0, 46369.0, 2, 104, 2, 376, 83, 293, 188.0, 11025.0, 46369.0
0, 0, 1, 1132, 1132, 1132, 1132.0, 0.0, 1281424.0, 0, 0, 0, 0, 0, 0, 0, 0, 0, 0, 0, 1, 1132, 1132, 1132, 1132.0, 0.0, 1281424.0
0, 0, 0, 0, 0, 0, 0, 0, 0, 0, 0, 0, 0, 0, 0, 0, 0, 0, 0, 0, 0, 0, 0, 0, 0, 0, 0
0, 0, 1, 1132, 1132, 1132, 1132.0, 0.0, 1281424.0, 0, 0, 0, 0, 0, 0, 0, 0, 0, 0, 0, 1, 1132, 1132, 1132, 1132.0, 0.0, 1281424.0
0, 0, 0, 0, 0, 0, 0, 0, 0, 0, 0, 0, 0, 0, 0, 0, 0, 0, 0, 0, 0, 0, 0, 0, 0, 0, 0
0, 0, 0, 0, 0, 0, 0, 0, 0, 0, 0, 0, 0, 0, 0, 0, 0, 0, 0, 0, 0, 0, 0, 0, 0, 0, 0
30, 1560, 2, 1154, 577, 577, 577.0, 0.0, 332929.0, 1, 52, 90, 818863, 1278, 18876, 9098.477777777778, 43495008.53839506, 126277306.41111112, 31, 1612, 92, 820017, 577, 18876, 8913.228260869566, 43806245.91788431, 123539385.16304348
0, 0, 0, 0, 0, 0, 0, 0, 0, 0, 0, 0, 0, 0, 0, 0, 0, 0, 0, 0, 0, 0, 0, 0, 0, 0, 0
0, 0, 0, 0, 0, 0, 0, 0, 0, 0, 0, 0, 0, 0, 0, 0, 0, 0, 0, 0, 0, 0, 0, 0, 0, 0, 0
0, 0, 1, 1132, 1132, 1132, 1132.0, 0.0, 1281424.0, 0, 0, 0, 0, 0, 0, 0, 0, 0, 0, 0, 1, 1132, 1132, 1132, 1132.0, 0.0, 1281424.0
0, 0, 0, 0, 0, 0, 0, 0, 0, 0, 0, 0, 0, 0, 0, 0, 0, 0, 0, 0, 0, 0, 0, 0, 0, 0, 0
4, 208, 0, 0, 0, 0, 0, 0, 0, 2, 104, 2, 166, 83, 83, 83.0, 0.0, 6889.0, 6, 312, 2, 166, 83, 83, 83.0, 0.0, 6889.0
0, 0, 0, 0, 0, 0, 0, 0, 0, 0, 0, 0, 0, 0, 0, 0, 0, 0, 0, 0, 0, 0, 0, 0, 0, 0, 0
0, 0, 0, 0, 0, 0, 0, 0, 0, 0, 0, 0, 0, 0, 0, 0, 0, 0, 0, 0, 0, 0, 0, 0, 0, 0, 0
0, 0, 0, 0, 0, 0, 0, 0, 0, 0, 0, 0, 0, 0, 0, 0, 0, 0, 0, 0, 0, 0, 0, 0, 0, 0, 0
0, 0, 0, 0, 0, 0, 0, 0, 0, 0, 0, 0, 0, 0, 0, 0, 0, 0, 0, 0, 0, 0, 0, 0, 0, 0, 0
1, 52, 0, 0, 0, 0, 0, 0, 0, 0, 0, 1, 83, 83, 83, 83.0, 0.0, 6889.0, 1, 52, 1, 83, 83, 83, 83.0, 0.0, 6889.0
38, 1976, 2, 1154, 577, 577, 577.0, 0.0, 332929.0, 0, 0, 93, 933451, 841, 20324, 10037.10752688172, 46753319.49381431, 147496847.0, 38, 1976, 95, 934605, 577, 20324, 9837.947368421053, 47197875.397917606, 144398659.25263157
0, 0, 0, 0, 0, 0, 0, 0, 0, 0, 0, 0, 0, 0, 0, 0, 0, 0, 0, 0, 0, 0, 0, 0, 0, 0, 0
0, 0, 0, 0, 0, 0, 0, 0, 0, 0, 0, 0, 0, 0, 0, 0, 0, 0, 0, 0, 0, 0, 0, 0, 0, 0, 0
0, 0, 0, 0, 0, 0, 0, 0, 0, 0, 0, 0, 0, 0, 0, 0, 0, 0, 0, 0, 0, 0, 0, 0, 0, 0, 0
2, 104, 3, 1860, 91, 1132, 620.0, 180758.0, 565158.0, 1, 52, 2, 422, 91, 331, 211.0, 14400.0, 58921.0, 3, 156, 5, 2282, 91, 1132, 456.4, 126663.06122448982, 362663.2
0, 0, 0, 0, 0, 0, 0, 0, 0, 0, 0, 0, 0, 0, 0, 0, 0, 0, 0, 0, 0, 0, 0, 0, 0, 0, 0
0, 0, 0, 0, 0, 0, 0, 0, 0, 0, 0, 0, 0, 0, 0, 0, 0, 0, 0, 0, 0, 0, 0, 0, 0, 0, 0
1, 60, 0, 0, 0, 0, 0, 0, 0, 0, 0, 0, 0, 0, 0, 0, 0, 0, 1, 60, 0, 0, 0, 0, 0, 0, 0
2, 112, 1, 569, 569, 569, 569.0, 0.0, 323761.0, 1, 60, 0, 0, 0, 0, 0, 0, 0, 3, 172, 1, 569, 569, 569, 569.0, 0.0, 323761.0
2, 104, 3, 1516, 103, 844, 505.3333333333333, 93540.2222222222, 348902.0, 1, 60, 1, 189, 189, 189, 189.0, 0.0, 35721.0, 3, 164, 4, 1705, 103, 844, 426.25, 80140.16, 270606.75
2, 104, 1, 103, 103, 103, 103.0, 0.0, 10609.0, 2, 104, 2, 490, 189, 301, 245.0, 3136.0, 63161.0, 4, 208, 3, 593, 103, 301, 197.66666666666666, 5735.039999999999, 45643.666666666664
31, 1612, 2, 1154, 577, 577, 577.0, 0.0, 332929.0, 0, 0, 76, 802451, 104, 20408, 10558.565789473685, 47453320.771987535, 158936632.3026316, 31, 1612, 78, 803605, 104, 20408, 10302.628205128205, 48114157.3594198, 154869870.67948717
0, 0, 0, 0, 0, 0, 0, 0, 0, 0, 0, 0, 0, 0, 0, 0, 0, 0, 0, 0, 0, 0, 0, 0, 0, 0, 0
0, 0, 0, 0, 0, 0, 0, 0, 0, 0, 0, 0, 0, 0, 0, 0, 0, 0, 0, 0, 0, 0, 0, 0, 0, 0, 0
0, 0, 0, 0, 0, 0, 0, 0, 0, 0, 0, 0, 0, 0, 0, 0, 0, 0, 0, 0, 0, 0, 0, 0, 0, 0, 0
0, 0, 0, 0, 0, 0, 0, 0, 0, 0, 0, 0, 0, 0, 0, 0, 0, 0, 0, 0, 0, 0, 0, 0, 0, 0, 0
0, 0, 0, 0, 0, 0, 0, 0, 0, 0, 0, 0, 0, 0, 0, 0, 0, 0, 0, 0, 0, 0, 0, 0, 0, 0, 0
0, 0, 0, 0, 0, 0, 0, 0, 0, 0, 0, 0, 0, 0, 0, 0, 0, 0, 0, 0, 0, 0, 0, 0, 0, 0, 0
2, 104, 0, 0, 0, 0, 0, 0, 0, 2, 104, 0, 0, 0, 0, 0, 0, 0, 4, 208, 0, 0, 0, 0, 0, 0, 0
0, 0, 0, 0, 0, 0, 0, 0, 0, 0, 0, 0, 0, 0, 0, 0, 0, 0, 0, 0, 0, 0, 0, 0, 0, 0, 0
0, 0, 0, 0, 0, 0, 0, 0, 0, 0, 0, 0, 0, 0, 0, 0, 0, 0, 0, 0, 0, 0, 0, 0, 0, 0, 0
0, 0, 0, 0, 0, 0, 0, 0, 0, 0, 0, 0, 0, 0, 0, 0, 0, 0, 0, 0, 0, 0, 0, 0, 0, 0, 0
0, 0, 1, 577, 577, 577, 577.0, 0.0, 332929.0, 0, 0, 0, 0, 0, 0, 0, 0, 0, 0, 0, 1, 577, 577, 577, 577.0, 0.0, 332929.0
20, 1040, 1, 577, 577, 577, 577.0, 0.0, 332929.0, 0, 0, 66, 679468, 800, 26116, 10294.969696969696, 63064839.21120294, 169051240.27272728, 20, 1040, 67, 680045, 577, 26116, 10149.925373134329, 63295395.81751371, 166533056.52238807
0, 0, 0, 0, 0, 0, 0, 0, 0, 0, 0, 0, 0, 0, 0, 0, 0, 0, 0, 0, 0, 0, 0, 0, 0, 0, 0
0, 0, 0, 0, 0, 0, 0, 0, 0, 0, 0, 0, 0, 0, 0, 0, 0, 0, 0, 0, 0, 0, 0, 0, 0, 0, 0
0, 0, 1, 1132, 1132, 1132, 1132.0, 0.0, 1281424.0, 0, 0, 0, 0, 0, 0, 0, 0, 0, 0, 0, 1, 1132, 1132, 1132, 1132.0, 0.0, 1281424.0
0, 0, 0, 0, 0, 0, 0, 0, 0, 0, 0, 0, 0, 0, 0, 0, 0, 0, 0, 0, 0, 0, 0, 0, 0, 0, 0
0, 0, 0, 0, 0, 0, 0, 0, 0, 0, 0, 0, 0, 0, 0, 0, 0, 0, 0, 0, 0, 0, 0, 0, 0, 0, 0
1, 52, 0, 0, 0, 0, 0, 0, 0, 1, 52, 0, 0, 0, 0, 0, 0, 0, 2, 104, 0, 0, 0, 0, 0, 0, 0
0, 0, 0, 0, 0, 0, 0, 0, 0, 0, 0, 0, 0, 0, 0, 0, 0, 0, 0, 0, 0, 0, 0, 0, 0, 0, 0
0, 0, 0, 0, 0, 0, 0, 0, 0, 0, 0, 0, 0, 0, 0, 0, 0, 0, 0, 0, 0, 0, 0, 0, 0, 0, 0
0, 0, 0, 0, 0, 0, 0, 0, 0, 0, 0, 0, 0, 0, 0, 0, 0, 0, 0, 0, 0, 0, 0, 0, 0, 0, 0
0, 0, 0, 0, 0, 0, 0, 0, 0, 0, 0, 0, 0, 0, 0, 0, 0, 0, 0, 0, 0, 0, 0, 0, 0, 0, 0
30, 1560, 2, 1154, 577, 577, 577.0, 0.0, 332929.0, 0, 0, 73, 814275, 1500, 24668, 11154.452054794521, 48923075.06961907, 173344875.71232876, 30, 1560, 75, 815429, 577, 24668, 10872.386666666667, 49753446.57414171, 168731223.8
2, 104, 0, 0, 0, 0, 0, 0, 0, 2, 104, 0, 0, 0, 0, 0, 0, 0, 4, 208, 0, 0, 0, 0, 0, 0, 0
0, 0, 0, 0, 0, 0, 0, 0, 0, 0, 0, 0, 0, 0, 0, 0, 0, 0, 0, 0, 0, 0, 0, 0, 0, 0, 0
0, 0, 0, 0, 0, 0, 0, 0, 0, 0, 0, 0, 0, 0, 0, 0, 0, 0, 0, 0, 0, 0, 0, 0, 0, 0, 0
3, 156, 0, 0, 0, 0, 0, 0, 0, 1, 52, 3, 459, 83, 293, 153.0, 9800.0, 33209.0, 4, 208, 3, 459, 83, 293, 153.0, 9800.0, 33209.0
0, 0, 0, 0, 0, 0, 0, 0, 0, 0, 0, 0, 0, 0, 0, 0, 0, 0, 0, 0, 0, 0, 0, 0, 0, 0, 0
0, 0, 0, 0, 0, 0, 0, 0, 0, 0, 0, 0, 0, 0, 0, 0, 0, 0, 0, 0, 0, 0, 0, 0, 0, 0, 0
0, 0, 0, 0, 0, 0, 0, 0, 0, 0, 0, 0, 0, 0, 0, 0, 0, 0, 0, 0, 0, 0, 0, 0, 0, 0, 0
0, 0, 0, 0, 0, 0, 0, 0, 0, 0, 0, 0, 0, 0, 0, 0, 0, 0, 0, 0, 0, 0, 0, 0, 0, 0, 0
0, 0, 0, 0, 0, 0, 0, 0, 0, 0, 0, 0, 0, 0, 0, 0, 0, 0, 0, 0, 0, 0, 0, 0, 0, 0, 0
4, 208, 1, 577, 577, 577, 577.0, 0.0, 332929.0, 1, 52, 7, 66186, 2948, 16465, 9455.142857142857, 31383130.97959184, 120782857.42857143, 5, 260, 8, 66763, 577, 16465, 8345.375, 34195366.19555555, 105726616.375
20, 1040, 1, 577, 577, 577, 577.0, 0.0, 332929.0, 0, 0, 86, 699476, 1500, 18585, 8133.441860465116, 40819356.13034072, 106972232.62790698, 20, 1040, 87, 700053, 577, 18585, 8046.586206896552, 40911554.978515826, 105746493.50574712
0, 0, 0, 0, 0, 0, 0, 0, 0, 0, 0, 0, 0, 0, 0, 0, 0, 0, 0, 0, 0, 0, 0, 0, 0, 0, 0
0, 0, 0, 0, 0, 0, 0, 0, 0, 0, 0, 0, 0, 0, 0, 0, 0, 0, 0, 0, 0, 0, 0, 0, 0, 0, 0
0, 0, 0, 0, 0, 0, 0, 0, 0, 0, 0, 0, 0, 0, 0, 0, 0, 0, 0, 0, 0, 0, 0, 0, 0, 0, 0
1, 60, 0, 0, 0, 0, 0, 0, 0, 0, 0, 0, 0, 0, 0, 0, 0, 0, 1, 60, 0, 0, 0, 0, 0, 0, 0
3, 164, 2, 1138, 569, 569, 569.0, 0.0, 323761.0, 2, 120, 0, 0, 0, 0, 0, 0, 0, 5, 284, 2, 1138, 569, 569, 569.0, 0.0, 323761.0
3, 156, 3, 993, 103, 787, 331.0, 103968.0, 213529.0, 1, 52, 3, 679, 189, 301, 226.33333333333334, 2787.555555555555, 54014.333333333336, 4, 208, 6, 1672, 103, 787, 278.6666666666667, 38948.83950617284, 133771.66666666666
0, 0, 0, 0, 0, 0, 0, 0, 0, 1, 52, 0, 0, 0, 0, 0, 0, 0, 1, 52, 0, 0, 0, 0, 0, 0, 0
0, 0, 0, 0, 0, 0, 0, 0, 0, 0, 0, 0, 0, 0, 0, 0, 0, 0, 0, 0, 0, 0, 0, 0, 0, 0, 0
0, 0, 0, 0, 0, 0, 0, 0, 0, 0, 0, 0, 0, 0, 0, 0, 0, 0, 0, 0, 0, 0, 0, 0, 0, 0, 0
16, 832, 2, 1154, 577, 577, 577.0, 0.0, 332929.0, 0, 0, 63, 602461, 1500, 20324, 9562.873015873016, 45415139.66641472, 136863679.98412699, 16, 832, 65, 603615, 577, 20324, 9286.384615384615, 45947469.65527344, 132662733.8
0, 0, 0, 0, 0, 0, 0, 0, 0, 0, 0, 0, 0, 0, 0, 0, 0, 0, 0, 0, 0, 0, 0, 0, 0, 0, 0
0, 0, 0, 0, 0, 0, 0, 0, 0, 0, 0, 0, 0, 0, 0, 0, 0, 0, 0, 0, 0, 0, 0, 0, 0, 0, 0
0, 0, 0, 0, 0, 0, 0, 0, 0, 0, 0, 0, 0, 0, 0, 0, 0, 0, 0, 0, 0, 0, 0, 0, 0, 0, 0
0, 0, 0, 0, 0, 0, 0, 0, 0, 0, 0, 0, 0, 0, 0, 0, 0, 0, 0, 0, 0, 0, 0, 0, 0, 0, 0
2, 104, 2, 728, 91, 637, 364.0, 74529.0, 207025.0, 1, 52, 2, 422, 91, 331, 211.0, 14400.0, 58921.0, 3, 156, 4, 1150, 91, 637, 287.5, 39645.0, 132973.0
0, 0, 0, 0, 0, 0, 0, 0, 0, 0, 0, 0, 0, 0, 0, 0, 0, 0, 0, 0, 0, 0, 0, 0, 0, 0, 0
0, 0, 0, 0, 0, 0, 0, 0, 0, 0, 0, 0, 0, 0, 0, 0, 0, 0, 0, 0, 0, 0, 0, 0, 0, 0, 0
0, 0, 0, 0, 0, 0, 0, 0, 0, 0, 0, 0, 0, 0, 0, 0, 0, 0, 0, 0, 0, 0, 0, 0, 0, 0, 0
0, 0, 1, 195, 195, 195, 195.0, 0.0, 38025.0, 0, 0, 0, 0, 0, 0, 0, 0, 0, 0, 0, 1, 195, 195, 195, 195.0, 0.0, 38025.0
0, 0, 0, 0, 0, 0, 0, 0, 0, 0, 0, 0, 0, 0, 0, 0, 0, 0, 0, 0, 0, 0, 0, 0, 0, 0, 0
13, 676, 2, 1154, 577, 577, 577.0, 0.0, 332929.0, 0, 0, 69, 660332, 1500, 23220, 9570.028985507246, 53943893.59336274, 145529348.3768116, 13, 676, 71, 661486, 577, 23220, 9316.704225352112, 54312112.53244897, 141439308.3943662
0, 0, 1, 195, 195, 195, 195.0, 0.0, 38025.0, 0, 0, 0, 0, 0, 0, 0, 0, 0, 0, 0, 1, 195, 195, 195, 195.0, 0.0, 38025.0
0, 0, 0, 0, 0, 0, 0, 0, 0, 0, 0, 0, 0, 0, 0, 0, 0, 0, 0, 0, 0, 0, 0, 0, 0, 0, 0
0, 0, 0, 0, 0, 0, 0, 0, 0, 0, 0, 0, 0, 0, 0, 0, 0, 0, 0, 0, 0, 0, 0, 0, 0, 0, 0
0, 0, 1, 195, 195, 195, 195.0, 0.0, 38025.0, 0, 0, 0, 0, 0, 0, 0, 0, 0, 0, 0, 1, 195, 195, 195, 195.0, 0.0, 38025.0
0, 0, 1, 1132, 1132, 1132, 1132.0, 0.0, 1281424.0, 0, 0, 0, 0, 0, 0, 0, 0, 0, 0, 0, 1, 1132, 1132, 1132, 1132.0, 0.0, 1281424.0
0, 0, 0, 0, 0, 0, 0, 0, 0, 0, 0, 0, 0, 0, 0, 0, 0, 0, 0, 0, 0, 0, 0, 0, 0, 0, 0
0, 0, 1, 195, 195, 195, 195.0, 0.0, 38025.0, 0, 0, 0, 0, 0, 0, 0, 0, 0, 0, 0, 1, 195, 195, 195, 195.0, 0.0, 38025.0
0, 0, 0, 0, 0, 0, 0, 0, 0, 0, 0, 0, 0, 0, 0, 0, 0, 0, 0, 0, 0, 0, 0, 0, 0, 0, 0
10, 520, 0, 0, 0, 0, 0, 0, 0, 10, 520, 0, 0, 0, 0, 0, 0, 0, 20, 1040, 0, 0, 0, 0, 0, 0, 0
0, 0, 0, 0, 0, 0, 0, 0, 0, 0, 0, 0, 0, 0, 0, 0, 0, 0, 0, 0, 0, 0, 0, 0, 0, 0, 0
0, 0, 1, 577, 577, 577, 577.0, 0.0, 332929.0, 0, 0, 0, 0, 0, 0, 0, 0, 0, 0, 0, 1, 577, 577, 577, 577.0, 0.0, 332929.0
24, 1248, 1, 577, 577, 577, 577.0, 0.0, 332929.0, 0, 0, 75, 717086, 1378, 21772, 9561.146666666667, 47007232.68515556, 138422758.26666668, 24, 1248, 76, 717663, 577, 21772, 9442.934210526315, 47226922.241042055, 136605786.82894737
2, 104, 1, 68, 68, 68, 68.0, 0.0, 4624.0, 1, 52, 1, 83, 83, 83, 83.0, 0.0, 6889.0, 3, 156, 2, 151, 68, 83, 75.5, 50.0, 5756.5
6, 312, 0, 0, 0, 0, 0, 0, 0, 5, 260, 2, 376, 83, 293, 188.0, 11025.0, 46369.0, 11, 572, 2, 376, 83, 293, 188.0, 11025.0, 46369.0
0, 0, 1, 68, 68, 68, 68.0, 0.0, 4624.0, 0, 0, 0, 0, 0, 0, 0, 0, 0, 0, 0, 1, 68, 68, 68, 68.0, 0.0, 4624.0
2, 104, 0, 0, 0, 0, 0, 0, 0, 1, 52, 1, 76, 76, 76, 76.0, 0.0, 5776.0, 3, 156, 1, 76, 76, 76, 76.0, 0.0, 5776.0
0, 0, 0, 0, 0, 0, 0, 0, 0, 1, 52, 0, 0, 0, 0, 0, 0, 0, 1, 52, 0, 0, 0, 0, 0, 0, 0
0, 0, 0, 0, 0, 0, 0, 0, 0, 0, 0, 0, 0, 0, 0, 0, 0, 0, 0, 0, 0, 0, 0, 0, 0, 0, 0
0, 0, 0, 0, 0, 0, 0, 0, 0, 0, 0, 0, 0, 0, 0, 0, 0, 0, 0, 0, 0, 0, 0, 0, 0, 0, 0
0, 0, 0, 0, 0, 0, 0, 0, 0, 0, 0, 0, 0, 0, 0, 0, 0, 0, 0, 0, 0, 0, 0, 0, 0, 0, 0
0, 0, 1, 68, 68, 68, 68.0, 0.0, 4624.0, 0, 0, 0, 0, 0, 0, 0, 0, 0, 0, 0, 1, 68, 68, 68, 68.0, 0.0, 4624.0
0, 0, 0, 0, 0, 0, 0, 0, 0, 0, 0, 0, 0, 0, 0, 0, 0, 0, 0, 0, 0, 0, 0, 0, 0, 0, 0
28, 1456, 3, 1354, 200, 577, 451.3333333333333, 31584.22222222223, 235286.0, 0, 0, 78, 682467, 294, 26116, 8749.576923076924, 52949844.85946746, 129504941.1923077, 28, 1456, 81, 683821, 200, 26116, 8442.234567901234, 53226134.00624975, 124717176.18518518
0, 0, 0, 0, 0, 0, 0, 0, 0, 1, 52, 0, 0, 0, 0, 0, 0, 0, 1, 52, 0, 0, 0, 0, 0, 0, 0
3, 172, 1, 569, 569, 569, 569.0, 0.0, 323761.0, 1, 60, 0, 0, 0, 0, 0, 0, 0, 4, 232, 1, 569, 569, 569, 569.0, 0.0, 323761.0
2, 104, 4, 1659, 103, 787, 414.75, 76417.1875, 248434.75, 1, 60, 1, 189, 189, 189, 189.0, 0.0, 35721.0, 3, 164, 5, 1848, 103, 787, 369.6, 62269.916666666664, 205892.0
2, 104, 1, 103, 103, 103, 103.0, 0.0, 10609.0, 1, 52, 2, 490, 189, 301, 245.0, 3136.0, 63161.0, 3, 156, 3, 593, 103, 301, 197.66666666666666, 5735.039999999999, 45643.666666666664
0, 0, 1, 200, 200, 200, 200.0, 0.0, 40000.0, 1, 52, 0, 0, 0, 0, 0, 0, 0, 1, 52, 1, 200, 200, 200, 200.0, 0.0, 40000.0
0, 0, 0, 0, 0, 0, 0, 0, 0, 0, 0, 0, 0, 0, 0, 0, 0, 0, 0, 0, 0, 0, 0, 0, 0, 0, 0
0, 0, 0, 0, 0, 0, 0, 0, 0, 0, 0, 0, 0, 0, 0, 0, 0, 0, 0, 0, 0, 0, 0, 0, 0, 0, 0
3, 156, 1, 200, 200, 200, 200.0, 0.0, 40000.0, 3, 156, 0, 0, 0, 0, 0, 0, 0, 6, 312, 1, 200, 200, 200, 200.0, 0.0, 40000.0
1, 52, 0, 0, 0, 0, 0, 0, 0, 1, 52, 0, 0, 0, 0, 0, 0, 0, 2, 104, 0, 0, 0, 0, 0, 0, 0
10, 480, 6, 4474, 83, 2948, 745.6666666666666, 1014949.5555555556, 1570968.3333333333, 6, 320, 6, 1269, 83, 346, 211.5, 13609.583333333334, 58341.833333333336, 16, 800, 12, 5743, 83, 2948, 478.5833333333333, 410797.1358024691, 814655.0833333334
24, 1248, 2, 1154, 577, 577, 577.0, 0.0, 332929.0, 0, 0, 64, 743598, 800, 23220, 11618.71875, 54393223.48339844, 189387848.875, 24, 1248, 66, 744752, 577, 23220, 11284.121212121212, 55403233.39171597, 183658911.9090909
1, 52, 0, 0, 0, 0, 0, 0, 0, 1, 52, 0, 0, 0, 0, 0, 0, 0, 2, 104, 0, 0, 0, 0, 0, 0, 0
0, 0, 0, 0, 0, 0, 0, 0, 0, 0, 0, 0, 0, 0, 0, 0, 0, 0, 0, 0, 0, 0, 0, 0, 0, 0, 0
0, 0, 0, 0, 0, 0, 0, 0, 0, 0, 0, 0, 0, 0, 0, 0, 0, 0, 0, 0, 0, 0, 0, 0, 0, 0, 0
0, 0, 0, 0, 0, 0, 0, 0, 0, 0, 0, 0, 0, 0, 0, 0, 0, 0, 0, 0, 0, 0, 0, 0, 0, 0, 0
0, 0, 0, 0, 0, 0, 0, 0, 0, 0, 0, 0, 0, 0, 0, 0, 0, 0, 0, 0, 0, 0, 0, 0, 0, 0, 0
0, 0, 0, 0, 0, 0, 0, 0, 0, 0, 0, 0, 0, 0, 0, 0, 0, 0, 0, 0, 0, 0, 0, 0, 0, 0, 0
0, 0, 0, 0, 0, 0, 0, 0, 0, 0, 0, 0, 0, 0, 0, 0, 0, 0, 0, 0, 0, 0, 0, 0, 0, 0, 0
0, 0, 0, 0, 0, 0, 0, 0, 0, 0, 0, 0, 0, 0, 0, 0, 0, 0, 0, 0, 0, 0, 0, 0, 0, 0, 0
0, 0, 0, 0, 0, 0, 0, 0, 0, 0, 0, 0, 0, 0, 0, 0, 0, 0, 0, 0, 0, 0, 0, 0, 0, 0, 0
0, 0, 1, 195, 195, 195, 195.0, 0.0, 38025.0, 0, 0, 0, 0, 0, 0, 0, 0, 0, 0, 0, 1, 195, 195, 195, 195.0, 0.0, 38025.0
2, 104, 1, 577, 577, 577, 577.0, 0.0, 332929.0, 0, 0, 6, 66137, 2948, 16465, 11022.833333333334, 27959731.13888889, 149462585.83333334, 2, 104, 7, 66714, 577, 16465, 9530.57142857143, 33556824.0591716, 128158349.14285715
29, 1508, 1, 577, 577, 577, 577.0, 0.0, 332929.0, 0, 0, 96, 779596, 1500, 17428, 8120.791666666667, 40703058.14409722, 106650315.4375, 29, 1508, 97, 780173, 577, 17428, 8043.020618556701, 40785497.88686944, 105554259.90721649
0, 0, 1, 195, 195, 195, 195.0, 0.0, 38025.0, 0, 0, 0, 0, 0, 0, 0, 0, 0, 0, 0, 1, 195, 195, 195, 195.0, 0.0, 38025.0
0, 0, 0, 0, 0, 0, 0, 0, 0, 0, 0, 0, 0, 0, 0, 0, 0, 0, 0, 0, 0, 0, 0, 0, 0, 0, 0
0, 0, 2, 728, 91, 637, 364.0, 74529.0, 207025.0, 0, 0, 0, 0, 0, 0, 0, 0, 0, 0, 0, 2, 728, 91, 637, 364.0, 74529.0, 207025.0
2, 104, 1, 195, 195, 195, 195.0, 0.0, 38025.0, 1, 52, 2, 422, 91, 331, 211.0, 14400.0, 58921.0, 3, 156, 3, 617, 91, 331, 205.66666666666666, 11560.960000000003, 51955.666666666664
0, 0, 0, 0, 0, 0, 0, 0, 0, 0, 0, 0, 0, 0, 0, 0, 0, 0, 0, 0, 0, 0, 0, 0, 0, 0, 0
1, 52, 0, 0, 0, 0, 0, 0, 0, 0, 0, 1, 83, 83, 83, 83.0, 0.0, 6889.0, 1, 52, 1, 83, 83, 83, 83.0, 0.0, 6889.0
0, 0, 1, 195, 195, 195, 195.0, 0.0, 38025.0, 0, 0, 0, 0, 0, 0, 0, 0, 0, 0, 0, 1, 195, 195, 195, 195.0, 0.0, 38025.0
0, 0, 0, 0, 0, 0, 0, 0, 0, 0, 0, 0, 0, 0, 0, 0, 0, 0, 0, 0, 0, 0, 0, 0, 0, 0, 0
2, 104, 0, 0, 0, 0, 0, 0, 0, 1, 52, 1, 83, 83, 83, 83.0, 0.0, 6889.0, 3, 156, 1, 83, 83, 83, 83.0, 0.0, 6889.0
1, 52, 0, 0, 0, 0, 0, 0, 0, 0, 0, 2, 376, 83, 293, 188.0, 11025.0, 46369.0, 1, 52, 2, 376, 83, 293, 188.0, 11025.0, 46369.0
37, 1924, 2, 1154, 577, 577, 577.0, 0.0, 332929.0, 1, 52, 99, 886082, 315, 23220, 8950.323232323231, 48240103.754106745, 128348389.71717171, 38, 1976, 101, 887236, 315, 23220, 8784.514851485148, 48451816.8819, 125813430.0990099
1, 52, 1, 1232, 1232, 1232, 1232.0, 0.0, 1517824.0, 0, 0, 1, 346, 346, 346, 346.0, 0.0, 119716.0, 1, 52, 2, 1578, 346, 1232, 789.0, 174443.55555555556, 818770.0
0, 0, 0, 0, 0, 0, 0, 0, 0, 0, 0, 0, 0, 0, 0, 0, 0, 0, 0, 0, 0, 0, 0, 0, 0, 0, 0
0, 0, 0, 0, 0, 0, 0, 0, 0, 0, 0, 0, 0, 0, 0, 0, 0, 0, 0, 0, 0, 0, 0, 0, 0, 0, 0
0, 0, 0, 0, 0, 0, 0, 0, 0, 0, 0, 0, 0, 0, 0, 0, 0, 0, 0, 0, 0, 0, 0, 0, 0, 0, 0
1, 52, 0, 0, 0, 0, 0, 0, 0, 2, 104, 1, 91, 91, 91, 91.0, 0.0, 8281.0, 3, 156, 1, 91, 91, 91, 91.0, 0.0, 8281.0
0, 0, 0, 0, 0, 0, 0, 0, 0, 0, 0, 0, 0, 0, 0, 0, 0, 0, 0, 0, 0, 0, 0, 0, 0, 0, 0
0, 0, 0, 0, 0, 0, 0, 0, 0, 0, 0, 0, 0, 0, 0, 0, 0, 0, 0, 0, 0, 0, 0, 0, 0, 0, 0
0, 0, 0, 0, 0, 0, 0, 0, 0, 0, 0, 0, 0, 0, 0, 0, 0, 0, 0, 0, 0, 0, 0, 0, 0, 0, 0
3, 164, 3, 1973, 577, 700, 657.6666666666666, 3256.222222222222, 435781.6666666667, 1, 52, 2, 508, 217, 291, 254.0, 1369.0, 65885.0, 4, 216, 5, 2481, 217, 700, 496.2, 42083.142857142855, 287823.0
29, 1516, 2, 1146, 569, 577, 573.0, 16.0, 328345.0, 1, 60, 93, 875141, 148, 26116, 9410.118279569893, 67623048.57740779, 156173374.61290324, 30, 1576, 95, 876287, 148, 26116, 9224.073684210527, 67725610.62698053, 152892426.62105262
2, 104, 2, 747, 178, 569, 373.5, 38220.25, 177722.5, 1, 60, 1, 5546, 5546, 5546, 5546.0, 0.0, 30758116.0, 3, 164, 3, 6293, 178, 5546, 2097.6666666666665, 6707799.1875, 10371187.0
1, 52, 2, 965, 178, 787, 482.5, 92720.25, 325526.5, 0, 0, 3, 5752, 103, 5546, 1917.3333333333333, 6583610.888888889, 10259778.0, 1, 52, 5, 6717, 103, 5546, 1343.4, 5346903.234375, 6286077.4
2, 104, 0, 0, 0, 0, 0, 0, 0, 0, 0, 1, 301, 301, 301, 301.0, 0.0, 90601.0, 2, 104, 1, 301, 301, 301, 301.0, 0.0, 90601.0
0, 0, 0, 0, 0, 0, 0, 0, 0, 0, 0, 0, 0, 0, 0, 0, 0, 0, 0, 0, 0, 0, 0, 0, 0, 0, 0
0, 0, 0, 0, 0, 0, 0, 0, 0, 0, 0, 0, 0, 0, 0, 0, 0, 0, 0, 0, 0, 0, 0, 0, 0, 0, 0
0, 0, 0, 0, 0, 0, 0, 0, 0, 0, 0, 0, 0, 0, 0, 0, 0, 0, 0, 0, 0, 0, 0, 0, 0, 0, 0
0, 0, 0, 0, 0, 0, 0, 0, 0, 0, 0, 0, 0, 0, 0, 0, 0, 0, 0, 0, 0, 0, 0, 0, 0, 0, 0
0, 0, 0, 0, 0, 0, 0, 0, 0, 0, 0, 0, 0, 0, 0, 0, 0, 0, 0, 0, 0, 0, 0, 0, 0, 0, 0
0, 0, 0, 0, 0, 0, 0, 0, 0, 0, 0, 0, 0, 0, 0, 0, 0, 0, 0, 0, 0, 0, 0, 0, 0, 0, 0
0, 0, 0, 0, 0, 0, 0, 0, 0, 0, 0, 0, 0, 0, 0, 0, 0, 0, 0, 0, 0, 0, 0, 0, 0, 0, 0
23, 1196, 2, 1154, 577, 577, 577.0, 0.0, 332929.0, 0, 0, 86, 784500, 326, 26116, 9122.093023255815, 63752580.45646296, 146965161.58139536, 23, 1196, 88, 785654, 326, 26116, 8927.886363636364, 63849439.53573788, 143632610.8409091
0, 0, 0, 0, 0, 0, 0, 0, 0, 0, 0, 0, 0, 0, 0, 0, 0, 0, 0, 0, 0, 0, 0, 0, 0, 0, 0
0, 0, 0, 0, 0, 0, 0, 0, 0, 0, 0, 0, 0, 0, 0, 0, 0, 0, 0, 0, 0, 0, 0, 0, 0, 0, 0
0, 0, 0, 0, 0, 0, 0, 0, 0, 0, 0, 0, 0, 0, 0, 0, 0, 0, 0, 0, 0, 0, 0, 0, 0, 0, 0
0, 0, 0, 0, 0, 0, 0, 0, 0, 0, 0, 0, 0, 0, 0, 0, 0, 0, 0, 0, 0, 0, 0, 0, 0, 0, 0
0, 0, 0, 0, 0, 0, 0, 0, 0, 0, 0, 0, 0, 0, 0, 0, 0, 0, 0, 0, 0, 0, 0, 0, 0, 0, 0
0, 0, 0, 0, 0, 0, 0, 0, 0, 0, 0, 0, 0, 0, 0, 0, 0, 0, 0, 0, 0, 0, 0, 0, 0, 0, 0
0, 0, 0, 0, 0, 0, 0, 0, 0, 0, 0, 0, 0, 0, 0, 0, 0, 0, 0, 0, 0, 0, 0, 0, 0, 0, 0
2, 104, 0, 0, 0, 0, 0, 0, 0, 2, 104, 1, 91, 91, 91, 91.0, 0.0, 8281.0, 4, 208, 1, 91, 91, 91, 91.0, 0.0, 8281.0
0, 0, 0, 0, 0, 0, 0, 0, 0, 0, 0, 0, 0, 0, 0, 0, 0, 0, 0, 0, 0, 0, 0, 0, 0, 0, 0
1, 52, 0, 0, 0, 0, 0, 0, 0, 1, 52, 0, 0, 0, 0, 0, 0, 0, 2, 104, 0, 0, 0, 0, 0, 0, 0
2, 104, 2, 1154, 577, 577, 577.0, 0.0, 332929.0, 0, 0, 7, 66009, 2948, 20324, 9429.857142857143, 44664740.97959184, 133586946.71428572, 2, 104, 9, 67163, 577, 20324, 7462.555555555556, 47653703.9375, 103974942.77777778
31, 1612, 0, 0, 0, 0, 0, 0, 0, 0, 0, 102, 913673, 1278, 23220, 8957.578431372549, 50252431.94973087, 130490643.30392157, 31, 1612, 102, 913673, 1278, 23220, 8957.578431372549, 50252431.94973087, 130490643.30392157
0, 0, 0, 0, 0, 0, 0, 0, 0, 0, 0, 0, 0, 0, 0, 0, 0, 0, 0, 0, 0, 0, 0, 0, 0, 0, 0
0, 0, 0, 0, 0, 0, 0, 0, 0, 0, 0, 0, 0, 0, 0, 0, 0, 0, 0, 0, 0, 0, 0, 0, 0, 0, 0
0, 0, 0, 0, 0, 0, 0, 0, 0, 0, 0, 0, 0, 0, 0, 0, 0, 0, 0, 0, 0, 0, 0, 0, 0, 0, 0
2, 104, 1, 1132, 1132, 1132, 1132.0, 0.0, 1281424.0, 2, 104, 0, 0, 0, 0, 0, 0, 0, 4, 208, 1, 1132, 1132, 1132, 1132.0, 0.0, 1281424.0
0, 0, 0, 0, 0, 0, 0, 0, 0, 0, 0, 0, 0, 0, 0, 0, 0, 0, 0, 0, 0, 0, 0, 0, 0, 0, 0
0, 0, 0, 0, 0, 0, 0, 0, 0, 0, 0, 0, 0, 0, 0, 0, 0, 0, 0, 0, 0, 0, 0, 0, 0, 0, 0
3, 156, 0, 0, 0, 0, 0, 0, 0, 1, 52, 3, 459, 83, 293, 153.0, 9800.0, 33209.0, 4, 208, 3, 459, 83, 293, 153.0, 9800.0, 33209.0
1, 52, 0, 0, 0, 0, 0, 0, 0, 0, 0, 0, 0, 0, 0, 0, 0, 0, 1, 52, 0, 0, 0, 0, 0, 0, 0
0, 0, 0, 0, 0, 0, 0, 0, 0, 0, 0, 0, 0, 0, 0, 0, 0, 0, 0, 0, 0, 0, 0, 0, 0, 0, 0
4, 208, 1, 577, 577, 577, 577.0, 0.0, 332929.0, 0, 0, 6, 66615, 2948, 19049, 11102.5, 43205470.25, 166470976.5, 4, 208, 7, 67192, 577, 19049, 9598.857142857143, 47748444.74556213, 142736969.7142857
22, 1144, 1, 577, 577, 577, 577.0, 0.0, 332929.0, 1, 52, 63, 711986, 1500, 29012, 11301.36507936508, 78772007.37465356, 206492860.03174603, 23, 1196, 64, 712563, 577, 29012, 11133.796875, 79050230.93868187, 203271611.109375
0, 0, 0, 0, 0, 0, 0, 0, 0, 0, 0, 0, 0, 0, 0, 0, 0, 0, 0, 0, 0, 0, 0, 0, 0, 0, 0
0, 0, 0, 0, 0, 0, 0, 0, 0, 0, 0, 0, 0, 0, 0, 0, 0, 0, 0, 0, 0, 0, 0, 0, 0, 0, 0
0, 0, 0, 0, 0, 0, 0, 0, 0, 0, 0, 0, 0, 0, 0, 0, 0, 0, 0, 0, 0, 0, 0, 0, 0, 0, 0
2, 104, 2, 728, 91, 637, 364.0, 74529.0, 207025.0, 1, 52, 2, 422, 91, 331, 211.0, 14400.0, 58921.0, 3, 156, 4, 1150, 91, 637, 287.5, 39645.0, 132973.0
0, 0, 0, 0, 0, 0, 0, 0, 0, 0, 0, 0, 0, 0, 0, 0, 0, 0, 0, 0, 0, 0, 0, 0, 0, 0, 0
0, 0, 0, 0, 0, 0, 0, 0, 0, 0, 0, 0, 0, 0, 0, 0, 0, 0, 0, 0, 0, 0, 0, 0, 0, 0, 0
1, 60, 0, 0, 0, 0, 0, 0, 0, 0, 0, 0, 0, 0, 0, 0, 0, 0, 1, 60, 0, 0, 0, 0, 0, 0, 0
3, 164, 2, 1138, 569, 569, 569.0, 0.0, 323761.0, 2, 120, 0, 0, 0, 0, 0, 0, 0, 5, 284, 2, 1138, 569, 569, 569.0, 0.0, 323761.0
2, 104, 3, 994, 103, 788, 331.3333333333333, 104272.22222222223, 214054.0, 1, 52, 3, 679, 189, 301, 226.33333333333334, 2787.555555555555, 54014.333333333336, 3, 156, 6, 1673, 103, 788, 278.8333333333333, 39065.77777777778, 134034.16666666666
1, 52, 0, 0, 0, 0, 0, 0, 0, 1, 52, 0, 0, 0, 0, 0, 0, 0, 2, 104, 0, 0, 0, 0, 0, 0, 0
22, 1144, 2, 1154, 577, 577, 577.0, 0.0, 332929.0, 0, 0, 62, 618288, 330, 23220, 9972.387096774193, 43753909.20499479, 143202413.61290324, 22, 1144, 64, 619442, 330, 23220, 9678.78125, 44438325.491055675, 138737742.21875
0, 0, 0, 0, 0, 0, 0, 0, 0, 0, 0, 0, 0, 0, 0, 0, 0, 0, 0, 0, 0, 0, 0, 0, 0, 0, 0
0, 0, 0, 0, 0, 0, 0, 0, 0, 0, 0, 0, 0, 0, 0, 0, 0, 0, 0, 0, 0, 0, 0, 0, 0, 0, 0
0, 0, 0, 0, 0, 0, 0, 0, 0, 0, 0, 0, 0, 0, 0, 0, 0, 0, 0, 0, 0, 0, 0, 0, 0, 0, 0
0, 0, 0, 0, 0, 0, 0, 0, 0, 0, 0, 0, 0, 0, 0, 0, 0, 0, 0, 0, 0, 0, 0, 0, 0, 0, 0
0, 0, 0, 0, 0, 0, 0, 0, 0, 0, 0, 0, 0, 0, 0, 0, 0, 0, 0, 0, 0, 0, 0, 0, 0, 0, 0
0, 0, 0, 0, 0, 0, 0, 0, 0, 0, 0, 0, 0, 0, 0, 0, 0, 0, 0, 0, 0, 0, 0, 0, 0, 0, 0
0, 0, 0, 0, 0, 0, 0, 0, 0, 0, 0, 0, 0, 0, 0, 0, 0, 0, 0, 0, 0, 0, 0, 0, 0, 0, 0
0, 0, 0, 0, 0, 0, 0, 0, 0, 0, 0, 0, 0, 0, 0, 0, 0, 0, 0, 0, 0, 0, 0, 0, 0, 0, 0
0, 0, 0, 0, 0, 0, 0, 0, 0, 0, 0, 0, 0, 0, 0, 0, 0, 0, 0, 0, 0, 0, 0, 0, 0, 0, 0
0, 0, 0, 0, 0, 0, 0, 0, 0, 0, 0, 0, 0, 0, 0, 0, 0, 0, 0, 0, 0, 0, 0, 0, 0, 0, 0
30, 1560, 2, 1154, 577, 577, 577.0, 0.0, 332929.0, 0, 0, 113, 1086663, 537, 23220, 9616.486725663717, 58760261.70115123, 151237078.6460177, 30, 1560, 115, 1087817, 537, 23220, 9459.278260869565, 58955308.05047707, 148612658.6521739
0, 0, 0, 0, 0, 0, 0, 0, 0, 0, 0, 0, 0, 0, 0, 0, 0, 0, 0, 0, 0, 0, 0, 0, 0, 0, 0
0, 0, 0, 0, 0, 0, 0, 0, 0, 0, 0, 0, 0, 0, 0, 0, 0, 0, 0, 0, 0, 0, 0, 0, 0, 0, 0
0, 0, 0, 0, 0, 0, 0, 0, 0, 0, 0, 0, 0, 0, 0, 0, 0, 0, 0, 0, 0, 0, 0, 0, 0, 0, 0
0, 0, 0, 0, 0, 0, 0, 0, 0, 0, 0, 0, 0, 0, 0, 0, 0, 0, 0, 0, 0, 0, 0, 0, 0, 0, 0
0, 0, 0, 0, 0, 0, 0, 0, 0, 0, 0, 0, 0, 0, 0, 0, 0, 0, 0, 0, 0, 0, 0, 0, 0, 0, 0
0, 0, 0, 0, 0, 0, 0, 0, 0, 0, 0, 0, 0, 0, 0, 0, 0, 0, 0, 0, 0, 0, 0, 0, 0, 0, 0
0, 0, 0, 0, 0, 0, 0, 0, 0, 0, 0, 0, 0, 0, 0, 0, 0, 0, 0, 0, 0, 0, 0, 0, 0, 0, 0
0, 0, 0, 0, 0, 0, 0, 0, 0, 0, 0, 0, 0, 0, 0, 0, 0, 0, 0, 0, 0, 0, 0, 0, 0, 0, 0
0, 0, 0, 0, 0, 0, 0, 0, 0, 0, 0, 0, 0, 0, 0, 0, 0, 0, 0, 0, 0, 0, 0, 0, 0, 0, 0
0, 0, 0, 0, 0, 0, 0, 0, 0, 0, 0, 0, 0, 0, 0, 0, 0, 0, 0, 0, 0, 0, 0, 0, 0, 0, 0
9, 468, 1, 577, 577, 577, 577.0, 0.0, 332929.0, 7, 364, 7, 66040, 2948, 17428, 9434.285714285714, 41235104.20408163, 130240851.14285715, 16, 832, 8, 66617, 577, 17428, 8327.125, 43367524.55999999, 114002360.875
55, 2860, 1, 577, 577, 577, 577.0, 0.0, 332929.0, 0, 0, 110, 1043557, 326, 18876, 9486.881818181819, 48782788.10421487, 138783714.73636365, 55, 2860, 111, 1044134, 326, 18876, 9406.612612612613, 48919638.75248254, 137536410.36036035
0, 0, 0, 0, 0, 0, 0, 0, 0, 0, 0, 0, 0, 0, 0, 0, 0, 0, 0, 0, 0, 0, 0, 0, 0, 0, 0
0, 0, 0, 0, 0, 0, 0, 0, 0, 0, 0, 0, 0, 0, 0, 0, 0, 0, 0, 0, 0, 0, 0, 0, 0, 0, 0
2, 104, 0, 0, 0, 0, 0, 0, 0, 1, 52, 1, 83, 83, 83, 83.0, 0.0, 6889.0, 3, 156, 1, 83, 83, 83, 83.0, 0.0, 6889.0
7, 364, 0, 0, 0, 0, 0, 0, 0, 6, 312, 2, 376, 83, 293, 188.0, 11025.0, 46369.0, 13, 676, 2, 376, 83, 293, 188.0, 11025.0, 46369.0
0, 0, 0, 0, 0, 0, 0, 0, 0, 0, 0, 0, 0, 0, 0, 0, 0, 0, 0, 0, 0, 0, 0, 0, 0, 0, 0
0, 0, 0, 0, 0, 0, 0, 0, 0, 0, 0, 0, 0, 0, 0, 0, 0, 0, 0, 0, 0, 0, 0, 0, 0, 0, 0
0, 0, 0, 0, 0, 0, 0, 0, 0, 0, 0, 0, 0, 0, 0, 0, 0, 0, 0, 0, 0, 0, 0, 0, 0, 0, 0
0, 0, 0, 0, 0, 0, 0, 0, 0, 0, 0, 0, 0, 0, 0, 0, 0, 0, 0, 0, 0, 0, 0, 0, 0, 0, 0
0, 0, 0, 0, 0, 0, 0, 0, 0, 0, 0, 0, 0, 0, 0, 0, 0, 0, 0, 0, 0, 0, 0, 0, 0, 0, 0
4, 208, 1, 577, 577, 577, 577.0, 0.0, 332929.0, 0, 0, 8, 66607, 1500, 16465, 8325.875, 26976231.859375, 96296426.375, 4, 208, 9, 67184, 577, 16465, 7464.888888888889, 28713688.878892735, 85633815.55555555
44, 2288, 1, 577, 577, 577, 577.0, 0.0, 332929.0, 1, 52, 94, 1039873, 441, 23220, 11062.478723404256, 65378791.292100504, 187757226.79787233, 45, 2340, 95, 1040450, 441, 23220, 10952.105263157895, 65611514.84656084, 185784339.4526316
0, 0, 0, 0, 0, 0, 0, 0, 0, 0, 0, 0, 0, 0, 0, 0, 0, 0, 0, 0, 0, 0, 0, 0, 0, 0, 0
0, 0, 1, 195, 195, 195, 195.0, 0.0, 38025.0, 0, 0, 0, 0, 0, 0, 0, 0, 0, 0, 0, 1, 195, 195, 195, 195.0, 0.0, 38025.0
0, 0, 0, 0, 0, 0, 0, 0, 0, 0, 0, 0, 0, 0, 0, 0, 0, 0, 0, 0, 0, 0, 0, 0, 0, 0, 0
3, 172, 1, 569, 569, 569, 569.0, 0.0, 323761.0, 1, 60, 0, 0, 0, 0, 0, 0, 0, 4, 232, 1, 569, 569, 569, 569.0, 0.0, 323761.0
2, 104, 4, 1654, 103, 787, 413.5, 76958.75, 247941.0, 1, 60, 1, 189, 189, 189, 189.0, 0.0, 35721.0, 3, 164, 5, 1843, 103, 787, 368.6, 62505.8888888889, 205497.0
2, 104, 1, 103, 103, 103, 103.0, 0.0, 10609.0, 1, 52, 2, 490, 189, 301, 245.0, 3136.0, 63161.0, 3, 156, 3, 593, 103, 301, 197.66666666666666, 5735.039999999999, 45643.666666666664
0, 0, 0, 0, 0, 0, 0, 0, 0, 1, 52, 0, 0, 0, 0, 0, 0, 0, 1, 52, 0, 0, 0, 0, 0, 0, 0
0, 0, 1, 195, 195, 195, 195.0, 0.0, 38025.0, 0, 0, 0, 0, 0, 0, 0, 0, 0, 0, 0, 1, 195, 195, 195, 195.0, 0.0, 38025.0
0, 0, 0, 0, 0, 0, 0, 0, 0, 0, 0, 0, 0, 0, 0, 0, 0, 0, 0, 0, 0, 0, 0, 0, 0, 0, 0
40, 2080, 1, 577, 577, 577, 577.0, 0.0, 332929.0, 0, 0, 106, 1042303, 815, 23220, 9833.047169811322, 58128514.70532218, 154817331.3490566, 40, 2080, 107, 1042880, 577, 23220, 9746.542056074766, 58255949.762745485, 153373551.88785046
4, 208, 2, 772, 195, 577, 386.0, 36481.0, 185477.0, 2, 104, 8, 66250, 2948, 17428, 8281.25, 20803178.6875, 89382280.25, 6, 312, 10, 67022, 195, 17428, 6702.2, 24652308.333333332, 71542919.6
0, 0, 0, 0, 0, 0, 0, 0, 0, 0, 0, 0, 0, 0, 0, 0, 0, 0, 0, 0, 0, 0, 0, 0, 0, 0, 0
0, 0, 0, 0, 0, 0, 0, 0, 0, 0, 0, 0, 0, 0, 0, 0, 0, 0, 0, 0, 0, 0, 0, 0, 0, 0, 0
0, 0, 0, 0, 0, 0, 0, 0, 0, 0, 0, 0, 0, 0, 0, 0, 0, 0, 0, 0, 0, 0, 0, 0, 0, 0, 0
2, 104, 2, 728, 91, 637, 364.0, 74529.0, 207025.0, 1, 52, 2, 422, 91, 331, 211.0, 14400.0, 58921.0, 3, 156, 4, 1150, 91, 637, 287.5, 39645.0, 132973.0
2, 104, 0, 0, 0, 0, 0, 0, 0, 2, 104, 0, 0, 0, 0, 0, 0, 0, 4, 208, 0, 0, 0, 0, 0, 0, 0
0, 0, 0, 0, 0, 0, 0, 0, 0, 0, 0, 0, 0, 0, 0, 0, 0, 0, 0, 0, 0, 0, 0, 0, 0, 0, 0
0, 0, 0, 0, 0, 0, 0, 0, 0, 0, 0, 0, 0, 0, 0, 0, 0, 0, 0, 0, 0, 0, 0, 0, 0, 0, 0
0, 0, 0, 0, 0, 0, 0, 0, 0, 0, 0, 0, 0, 0, 0, 0, 0, 0, 0, 0, 0, 0, 0, 0, 0, 0, 0
0, 0, 0, 0, 0, 0, 0, 0, 0, 0, 0, 0, 0, 0, 0, 0, 0, 0, 0, 0, 0, 0, 0, 0, 0, 0, 0
26, 1352, 2, 1154, 577, 577, 577.0, 0.0, 332929.0, 0, 0, 114, 1106654, 503, 27564, 9707.491228070176, 64063926.26746691, 158299312.21052632, 26, 1352, 116, 1107808, 503, 27564, 9550.068965517241, 64225465.59954631, 155575753.87931034
0, 0, 0, 0, 0, 0, 0, 0, 0, 0, 0, 0, 0, 0, 0, 0, 0, 0, 0, 0, 0, 0, 0, 0, 0, 0, 0
2, 104, 0, 0, 0, 0, 0, 0, 0, 2, 104, 1, 76, 76, 76, 76.0, 0.0, 5776.0, 4, 208, 1, 76, 76, 76, 76.0, 0.0, 5776.0
0, 0, 0, 0, 0, 0, 0, 0, 0, 0, 0, 0, 0, 0, 0, 0, 0, 0, 0, 0, 0, 0, 0, 0, 0, 0, 0
0, 0, 0, 0, 0, 0, 0, 0, 0, 0, 0, 0, 0, 0, 0, 0, 0, 0, 0, 0, 0, 0, 0, 0, 0, 0, 0
0, 0, 0, 0, 0, 0, 0, 0, 0, 0, 0, 0, 0, 0, 0, 0, 0, 0, 0, 0, 0, 0, 0, 0, 0, 0, 0
0, 0, 0, 0, 0, 0, 0, 0, 0, 0, 0, 0, 0, 0, 0, 0, 0, 0, 0, 0, 0, 0, 0, 0, 0, 0, 0
0, 0, 0, 0, 0, 0, 0, 0, 0, 0, 0, 0, 0, 0, 0, 0, 0, 0, 0, 0, 0, 0, 0, 0, 0, 0, 0
0, 0, 0, 0, 0, 0, 0, 0, 0, 0, 0, 0, 0, 0, 0, 0, 0, 0, 0, 0, 0, 0, 0, 0, 0, 0, 0
0, 0, 0, 0, 0, 0, 0, 0, 0, 0, 0, 0, 0, 0, 0, 0, 0, 0, 0, 0, 0, 0, 0, 0, 0, 0, 0
0, 0, 1, 195, 195, 195, 195.0, 0.0, 38025.0, 0, 0, 0, 0, 0, 0, 0, 0, 0, 0, 0, 1, 195, 195, 195, 195.0, 0.0, 38025.0
2, 104, 2, 1154, 577, 577, 577.0, 0.0, 332929.0, 0, 0, 5, 66096, 7777, 21478, 13219.2, 26186058.159999996, 200933306.8, 2, 104, 7, 67250, 577, 21478, 9607.142857142857, 44019662.47222222, 143618913.14285713
58, 3016, 0, 0, 0, 0, 0, 0, 0, 0, 0, 88, 1025713, 537, 26116, 11655.829545454546, 57205629.11867252, 193063991.51136363, 58, 3016, 88, 1025713, 537, 26116, 11655.829545454546, 57205629.11867252, 193063991.51136363
2, 104, 1, 195, 195, 195, 195.0, 0.0, 38025.0, 1, 52, 1, 83, 83, 83, 83.0, 0.0, 6889.0, 3, 156, 2, 278, 83, 195, 139.0, 2787.555555555556, 22457.0
1, 52, 0, 0, 0, 0, 0, 0, 0, 0, 0, 2, 376, 83, 293, 188.0, 11025.0, 46369.0, 1, 52, 2, 376, 83, 293, 188.0, 11025.0, 46369.0
0, 0, 0, 0, 0, 0, 0, 0, 0, 0, 0, 0, 0, 0, 0, 0, 0, 0, 0, 0, 0, 0, 0, 0, 0, 0, 0
0, 0, 1, 195, 195, 195, 195.0, 0.0, 38025.0, 0, 0, 0, 0, 0, 0, 0, 0, 0, 0, 0, 1, 195, 195, 195, 195.0, 0.0, 38025.0
0, 0, 0, 0, 0, 0, 0, 0, 0, 0, 0, 0, 0, 0, 0, 0, 0, 0, 0, 0, 0, 0, 0, 0, 0, 0, 0
0, 0, 0, 0, 0, 0, 0, 0, 0, 0, 0, 0, 0, 0, 0, 0, 0, 0, 0, 0, 0, 0, 0, 0, 0, 0, 0
0, 0, 1, 195, 195, 195, 195.0, 0.0, 38025.0, 0, 0, 0, 0, 0, 0, 0, 0, 0, 0, 0, 1, 195, 195, 195, 195.0, 0.0, 38025.0
0, 0, 0, 0, 0, 0, 0, 0, 0, 0, 0, 0, 0, 0, 0, 0, 0, 0, 0, 0, 0, 0, 0, 0, 0, 0, 0
0, 0, 0, 0, 0, 0, 0, 0, 0, 0, 0, 0, 0, 0, 0, 0, 0, 0, 0, 0, 0, 0, 0, 0, 0, 0, 0
4, 208, 1, 577, 577, 577, 577.0, 0.0, 332929.0, 0, 0, 6, 66381, 5844, 17428, 11063.5, 19527573.583333332, 141928605.83333334, 4, 208, 7, 66958, 577, 17428, 9565.42857142857, 25833737.668639056, 121700652.0
23, 1196, 1, 577, 577, 577, 577.0, 0.0, 332929.0, 1, 52, 82, 633012, 315, 23220, 7719.658536585366, 46066836.81023201, 105659964.73170732, 24, 1248, 83, 633589, 315, 23220, 7633.6024096385545, 46094967.33605142, 104390964.30120482
1, 60, 0, 0, 0, 0, 0, 0, 0, 0, 0, 0, 0, 0, 0, 0, 0, 0, 1, 60, 0, 0, 0, 0, 0, 0, 0
2, 112, 1, 569, 569, 569, 569.0, 0.0, 323761.0, 1, 60, 0, 0, 0, 0, 0, 0, 0, 3, 172, 1, 569, 569, 569, 569.0, 0.0, 323761.0
2, 104, 3, 1460, 103, 788, 486.6666666666667, 81593.55555555556, 318438.0, 1, 60, 1, 189, 189, 189, 189.0, 0.0, 35721.0, 3, 164, 4, 1649, 103, 788, 412.25, 70221.44, 247758.75
2, 104, 1, 103, 103, 103, 103.0, 0.0, 10609.0, 2, 104, 2, 490, 189, 301, 245.0, 3136.0, 63161.0, 4, 208, 3, 593, 103, 301, 197.66666666666666, 5735.039999999999, 45643.666666666664
0, 0, 0, 0, 0, 0, 0, 0, 0, 0, 0, 0, 0, 0, 0, 0, 0, 0, 0, 0, 0, 0, 0, 0, 0, 0, 0
0, 0, 0, 0, 0, 0, 0, 0, 0, 0, 0, 0, 0, 0, 0, 0, 0, 0, 0, 0, 0, 0, 0, 0, 0, 0, 0
0, 0, 0, 0, 0, 0, 0, 0, 0, 0, 0, 0, 0, 0, 0, 0, 0, 0, 0, 0, 0, 0, 0, 0, 0, 0, 0
0, 0, 0, 0, 0, 0, 0, 0, 0, 0, 0, 0, 0, 0, 0, 0, 0, 0, 0, 0, 0, 0, 0, 0, 0, 0, 0
0, 0, 0, 0, 0, 0, 0, 0, 0, 0, 0, 0, 0, 0, 0, 0, 0, 0, 0, 0, 0, 0, 0, 0, 0, 0, 0
0, 0, 1, 577, 577, 577, 577.0, 0.0, 332929.0, 0, 0, 0, 0, 0, 0, 0, 0, 0, 0, 0, 1, 577, 577, 577, 577.0, 0.0, 332929.0
20, 1040, 1, 577, 577, 577, 577.0, 0.0, 332929.0, 0, 0, 78, 704905, 1241, 23220, 9037.24358974359, 59327652.05604866, 140999423.75641027, 20, 1040, 79, 705482, 577, 23220, 8930.151898734177, 59402761.43965272, 139218835.21518987
0, 0, 0, 0, 0, 0, 0, 0, 0, 0, 0, 0, 0, 0, 0, 0, 0, 0, 0, 0, 0, 0, 0, 0, 0, 0, 0
0, 0, 0, 0, 0, 0, 0, 0, 0, 0, 0, 0, 0, 0, 0, 0, 0, 0, 0, 0, 0, 0, 0, 0, 0, 0, 0
0, 0, 0, 0, 0, 0, 0, 0, 0, 0, 0, 0, 0, 0, 0, 0, 0, 0, 0, 0, 0, 0, 0, 0, 0, 0, 0
0, 0, 0, 0, 0, 0, 0, 0, 0, 0, 0, 0, 0, 0, 0, 0, 0, 0, 0, 0, 0, 0, 0, 0, 0, 0, 0
0, 0, 0, 0, 0, 0, 0, 0, 0, 0, 0, 0, 0, 0, 0, 0, 0, 0, 0, 0, 0, 0, 0, 0, 0, 0, 0
0, 0, 0, 0, 0, 0, 0, 0, 0, 0, 0, 0, 0, 0, 0, 0, 0, 0, 0, 0, 0, 0, 0, 0, 0, 0, 0
0, 0, 0, 0, 0, 0, 0, 0, 0, 0, 0, 0, 0, 0, 0, 0, 0, 0, 0, 0, 0, 0, 0, 0, 0, 0, 0
0, 0, 0, 0, 0, 0, 0, 0, 0, 0, 0, 0, 0, 0, 0, 0, 0, 0, 0, 0, 0, 0, 0, 0, 0, 0, 0
0, 0, 0, 0, 0, 0, 0, 0, 0, 0, 0, 0, 0, 0, 0, 0, 0, 0, 0, 0, 0, 0, 0, 0, 0, 0, 0
0, 0, 0, 0, 0, 0, 0, 0, 0, 0, 0, 0, 0, 0, 0, 0, 0, 0, 0, 0, 0, 0, 0, 0, 0, 0, 0
31, 1612, 2, 1154, 577, 577, 577.0, 0.0, 332929.0, 0, 0, 78, 881614, 1500, 26116, 11302.74358974359, 51916485.447074294, 179668498.1025641, 31, 1612, 80, 882768, 577, 26116, 11034.6, 52697104.02467554, 175185108.875
1, 52, 1, 195, 195, 195, 195.0, 0.0, 38025.0, 1, 52, 0, 0, 0, 0, 0, 0, 0, 2, 104, 1, 195, 195, 195, 195.0, 0.0, 38025.0
0, 0, 0, 0, 0, 0, 0, 0, 0, 0, 0, 0, 0, 0, 0, 0, 0, 0, 0, 0, 0, 0, 0, 0, 0, 0, 0
0, 0, 0, 0, 0, 0, 0, 0, 0, 0, 0, 0, 0, 0, 0, 0, 0, 0, 0, 0, 0, 0, 0, 0, 0, 0, 0
2, 104, 3, 923, 91, 637, 307.6666666666667, 56032.88888888888, 150691.66666666666, 1, 52, 2, 422, 91, 331, 211.0, 14400.0, 58921.0, 3, 156, 5, 1345, 91, 637, 269.0, 34531.102040816324, 113983.4
0, 0, 0, 0, 0, 0, 0, 0, 0, 0, 0, 0, 0, 0, 0, 0, 0, 0, 0, 0, 0, 0, 0, 0, 0, 0, 0
0, 0, 1, 200, 200, 200, 200.0, 0.0, 40000.0, 0, 0, 0, 0, 0, 0, 0, 0, 0, 0, 0, 1, 200, 200, 200, 200.0, 0.0, 40000.0
2, 104, 1, 195, 195, 195, 195.0, 0.0, 38025.0, 2, 104, 0, 0, 0, 0, 0, 0, 0, 4, 208, 1, 195, 195, 195, 195.0, 0.0, 38025.0
0, 0, 0, 0, 0, 0, 0, 0, 0, 0, 0, 0, 0, 0, 0, 0, 0, 0, 0, 0, 0, 0, 0, 0, 0, 0, 0
1, 52, 1, 200, 200, 200, 200.0, 0.0, 40000.0, 1, 52, 1, 83, 83, 83, 83.0, 0.0, 6889.0, 2, 104, 2, 283, 83, 200, 141.5, 3042.0, 23444.5
2, 104, 1, 195, 195, 195, 195.0, 0.0, 38025.0, 0, 0, 2, 376, 83, 293, 188.0, 11025.0, 46369.0, 2, 104, 3, 571, 83, 293, 190.33333333333334, 8827.84, 43587.666666666664
0, 0, 0, 0, 0, 0, 0, 0, 0, 0, 0, 0, 0, 0, 0, 0, 0, 0, 0, 0, 0, 0, 0, 0, 0, 0, 0
33, 1716, 2, 777, 200, 577, 388.5, 35532.25, 186464.5, 1, 52, 100, 886569, 852, 20324, 8865.69, 44417719.5139, 123018178.69, 34, 1768, 102, 887346, 200, 20324, 8699.470588235294, 44682759.61937555, 120609713.70588236
0, 0, 1, 195, 195, 195, 195.0, 0.0, 38025.0, 0, 0, 0, 0, 0, 0, 0, 0, 0, 0, 0, 1, 195, 195, 195, 195.0, 0.0, 38025.0
0, 0, 0, 0, 0, 0, 0, 0, 0, 0, 0, 0, 0, 0, 0, 0, 0, 0, 0, 0, 0, 0, 0, 0, 0, 0, 0
0, 0, 1, 200, 200, 200, 200.0, 0.0, 40000.0, 0, 0, 0, 0, 0, 0, 0, 0, 0, 0, 0, 1, 200, 200, 200, 200.0, 0.0, 40000.0
0, 0, 1, 195, 195, 195, 195.0, 0.0, 38025.0, 0, 0, 0, 0, 0, 0, 0, 0, 0, 0, 0, 1, 195, 195, 195, 195.0, 0.0, 38025.0
0, 0, 0, 0, 0, 0, 0, 0, 0, 0, 0, 0, 0, 0, 0, 0, 0, 0, 0, 0, 0, 0, 0, 0, 0, 0, 0
0, 0, 1, 195, 195, 195, 195.0, 0.0, 38025.0, 0, 0, 0, 0, 0, 0, 0, 0, 0, 0, 0, 1, 195, 195, 195, 195.0, 0.0, 38025.0
0, 0, 0, 0, 0, 0, 0, 0, 0, 0, 0, 0, 0, 0, 0, 0, 0, 0, 0, 0, 0, 0, 0, 0, 0, 0, 0
0, 0, 0, 0, 0, 0, 0, 0, 0, 0, 0, 0, 0, 0, 0, 0, 0, 0, 0, 0, 0, 0, 0, 0, 0, 0, 0
3, 164, 3, 1593, 195, 701, 531.0, 56450.666666666664, 338411.6666666667, 0, 0, 2, 508, 217, 291, 254.0, 1369.0, 65885.0, 3, 164, 5, 2101, 195, 701, 420.2, 43766.204081632655, 229401.0
3, 164, 2, 1138, 569, 569, 569.0, 0.0, 323761.0, 2, 120, 0, 0, 0, 0, 0, 0, 0, 5, 284, 2, 1138, 569, 569, 569.0, 0.0, 323761.0
39, 2036, 11, 5783, 72, 2948, 525.7272727272727, 648424.7438016528, 924813.9090909091, 5, 268, 126, 1066446, 122, 23220, 8463.857142857143, 56218932.17006802, 127855809.90476191, 44, 2304, 137, 1072229, 72, 23220, 7826.489051094891, 56420020.35972763, 117664270.08029197
0, 0, 0, 0, 0, 0, 0, 0, 0, 1, 52, 0, 0, 0, 0, 0, 0, 0, 1, 52, 0, 0, 0, 0, 0, 0, 0
0, 0, 0, 0, 0, 0, 0, 0, 0, 0, 0, 0, 0, 0, 0, 0, 0, 0, 0, 0, 0, 0, 0, 0, 0, 0, 0
0, 0, 0, 0, 0, 0, 0, 0, 0, 0, 0, 0, 0, 0, 0, 0, 0, 0, 0, 0, 0, 0, 0, 0, 0, 0, 0
0, 0, 0, 0, 0, 0, 0, 0, 0, 0, 0, 0, 0, 0, 0, 0, 0, 0, 0, 0, 0, 0, 0, 0, 0, 0, 0
0, 0, 0, 0, 0, 0, 0, 0, 0, 0, 0, 0, 0, 0, 0, 0, 0, 0, 0, 0, 0, 0, 0, 0, 0, 0, 0
0, 0, 0, 0, 0, 0, 0, 0, 0, 0, 0, 0, 0, 0, 0, 0, 0, 0, 0, 0, 0, 0, 0, 0, 0, 0, 0
0, 0, 0, 0, 0, 0, 0, 0, 0, 0, 0, 0, 0, 0, 0, 0, 0, 0, 0, 0, 0, 0, 0, 0, 0, 0, 0
0, 0, 0, 0, 0, 0, 0, 0, 0, 0, 0, 0, 0, 0, 0, 0, 0, 0, 0, 0, 0, 0, 0, 0, 0, 0, 0
0, 0, 0, 0, 0, 0, 0, 0, 0, 0, 0, 0, 0, 0, 0, 0, 0, 0, 0, 0, 0, 0, 0, 0, 0, 0, 0
22, 1144, 1, 577, 577, 577, 577.0, 0.0, 332929.0, 1, 52, 103, 918003, 315, 23220, 8912.650485436894, 49747748.46036385, 129183087.13592233, 23, 1196, 104, 918580, 315, 23220, 8832.5, 49841466.59347943, 127944143.3076923
3, 156, 0, 0, 0, 0, 0, 0, 0, 0, 0, 4, 36943, 3961, 16465, 9235.75, 20614690.6875, 105913768.75, 3, 156, 4, 36943, 3961, 16465, 9235.75, 20614690.6875, 105913768.75
0, 0, 0, 0, 0, 0, 0, 0, 0, 0, 0, 0, 0, 0, 0, 0, 0, 0, 0, 0, 0, 0, 0, 0, 0, 0, 0
0, 0, 0, 0, 0, 0, 0, 0, 0, 0, 0, 0, 0, 0, 0, 0, 0, 0, 0, 0, 0, 0, 0, 0, 0, 0, 0
0, 0, 0, 0, 0, 0, 0, 0, 0, 0, 0, 0, 0, 0, 0, 0, 0, 0, 0, 0, 0, 0, 0, 0, 0, 0, 0
0, 0, 0, 0, 0, 0, 0, 0, 0, 0, 0, 0, 0, 0, 0, 0, 0, 0, 0, 0, 0, 0, 0, 0, 0, 0, 0
0, 0, 0, 0, 0, 0, 0, 0, 0, 0, 0, 0, 0, 0, 0, 0, 0, 0, 0, 0, 0, 0, 0, 0, 0, 0, 0
0, 0, 0, 0, 0, 0, 0, 0, 0, 0, 0, 0, 0, 0, 0, 0, 0, 0, 0, 0, 0, 0, 0, 0, 0, 0, 0
0, 0, 0, 0, 0, 0, 0, 0, 0, 0, 0, 0, 0, 0, 0, 0, 0, 0, 0, 0, 0, 0, 0, 0, 0, 0, 0
0, 0, 0, 0, 0, 0, 0, 0, 0, 0, 0, 0, 0, 0, 0, 0, 0, 0, 0, 0, 0, 0, 0, 0, 0, 0, 0
0, 0, 0, 0, 0, 0, 0, 0, 0, 0, 0, 0, 0, 0, 0, 0, 0, 0, 0, 0, 0, 0, 0, 0, 0, 0, 0
0, 0, 0, 0, 0, 0, 0, 0, 0, 0, 0, 0, 0, 0, 0, 0, 0, 0, 0, 0, 0, 0, 0, 0, 0, 0, 0
25, 1300, 1, 577, 577, 577, 577.0, 0.0, 332929.0, 1, 52, 76, 723647, 1254, 29012, 9521.671052631578, 60068822.03653048, 150731041.67105263, 26, 1352, 77, 724224, 577, 29012, 9405.506493506493, 60195720.04775941, 148777819.42857143
0, 0, 0, 0, 0, 0, 0, 0, 0, 0, 0, 0, 0, 0, 0, 0, 0, 0, 0, 0, 0, 0, 0, 0, 0, 0, 0
7, 364, 0, 0, 0, 0, 0, 0, 0, 7, 364, 0, 0, 0, 0, 0, 0, 0, 14, 728, 0, 0, 0, 0, 0, 0, 0
0, 0, 0, 0, 0, 0, 0, 0, 0, 0, 0, 0, 0, 0, 0, 0, 0, 0, 0, 0, 0, 0, 0, 0, 0, 0, 0
0, 0, 0, 0, 0, 0, 0, 0, 0, 0, 0, 0, 0, 0, 0, 0, 0, 0, 0, 0, 0, 0, 0, 0, 0, 0, 0
0, 0, 0, 0, 0, 0, 0, 0, 0, 0, 0, 0, 0, 0, 0, 0, 0, 0, 0, 0, 0, 0, 0, 0, 0, 0, 0
2, 104, 0, 0, 0, 0, 0, 0, 0, 1, 52, 1, 83, 83, 83, 83.0, 0.0, 6889.0, 3, 156, 1, 83, 83, 83, 83.0, 0.0, 6889.0
1, 52, 0, 0, 0, 0, 0, 0, 0, 0, 0, 2, 376, 83, 293, 188.0, 11025.0, 46369.0, 1, 52, 2, 376, 83, 293, 188.0, 11025.0, 46369.0
6, 312, 0, 0, 0, 0, 0, 0, 0, 6, 312, 0, 0, 0, 0, 0, 0, 0, 12, 624, 0, 0, 0, 0, 0, 0, 0
0, 0, 0, 0, 0, 0, 0, 0, 0, 0, 0, 0, 0, 0, 0, 0, 0, 0, 0, 0, 0, 0, 0, 0, 0, 0, 0
0, 0, 0, 0, 0, 0, 0, 0, 0, 0, 0, 0, 0, 0, 0, 0, 0, 0, 0, 0, 0, 0, 0, 0, 0, 0, 0
21, 1092, 1, 577, 577, 577, 577.0, 0.0, 332929.0, 0, 0, 94, 910856, 1289, 20324, 9689.95744680851, 47284342.76414667, 141179618.08510637, 21, 1092, 95, 911433, 577, 20324, 9594.031578947368, 47471232.99627671, 139697021.35789475
0, 0, 0, 0, 0, 0, 0, 0, 0, 1, 52, 0, 0, 0, 0, 0, 0, 0, 1, 52, 0, 0, 0, 0, 0, 0, 0
0, 0, 0, 0, 0, 0, 0, 0, 0, 0, 0, 0, 0, 0, 0, 0, 0, 0, 0, 0, 0, 0, 0, 0, 0, 0, 0
0, 0, 0, 0, 0, 0, 0, 0, 0, 0, 0, 0, 0, 0, 0, 0, 0, 0, 0, 0, 0, 0, 0, 0, 0, 0, 0
2, 104, 2, 728, 91, 637, 364.0, 74529.0, 207025.0, 1, 52, 2, 422, 91, 331, 211.0, 14400.0, 58921.0, 3, 156, 4, 1150, 91, 637, 287.5, 39645.0, 132973.0
0, 0, 0, 0, 0, 0, 0, 0, 0, 0, 0, 0, 0, 0, 0, 0, 0, 0, 0, 0, 0, 0, 0, 0, 0, 0, 0
0, 0, 0, 0, 0, 0, 0, 0, 0, 0, 0, 0, 0, 0, 0, 0, 0, 0, 0, 0, 0, 0, 0, 0, 0, 0, 0
3, 172, 1, 569, 569, 569, 569.0, 0.0, 323761.0, 1, 60, 0, 0, 0, 0, 0, 0, 0, 4, 232, 1, 569, 569, 569, 569.0, 0.0, 323761.0
2, 104, 3, 1460, 103, 788, 486.6666666666667, 81593.55555555556, 318438.0, 1, 60, 1, 189, 189, 189, 189.0, 0.0, 35721.0, 3, 164, 4, 1649, 103, 788, 412.25, 70221.44, 247758.75
2, 104, 1, 103, 103, 103, 103.0, 0.0, 10609.0, 1, 52, 2, 490, 189, 301, 245.0, 3136.0, 63161.0, 3, 156, 3, 593, 103, 301, 197.66666666666666, 5735.039999999999, 45643.666666666664
0, 0, 0, 0, 0, 0, 0, 0, 0, 1, 52, 0, 0, 0, 0, 0, 0, 0, 1, 52, 0, 0, 0, 0, 0, 0, 0
0, 0, 1, 577, 577, 577, 577.0, 0.0, 332929.0, 0, 0, 0, 0, 0, 0, 0, 0, 0, 0, 0, 1, 577, 577, 577, 577.0, 0.0, 332929.0
33, 1716, 0, 0, 0, 0, 0, 0, 0, 0, 0, 114, 911057, 1179, 20324, 7991.728070175439, 42926924.145352416, 106794641.69298245, 33, 1716, 114, 911057, 1179, 20324, 7991.728070175439, 42926924.145352416, 106794641.69298245
0, 0, 0, 0, 0, 0, 0, 0, 0, 0, 0, 0, 0, 0, 0, 0, 0, 0, 0, 0, 0, 0, 0, 0, 0, 0, 0
2, 104, 0, 0, 0, 0, 0, 0, 0, 2, 104, 0, 0, 0, 0, 0, 0, 0, 4, 208, 0, 0, 0, 0, 0, 0, 0
0, 0, 0, 0, 0, 0, 0, 0, 0, 0, 0, 0, 0, 0, 0, 0, 0, 0, 0, 0, 0, 0, 0, 0, 0, 0, 0
0, 0, 1, 195, 195, 195, 195.0, 0.0, 38025.0, 0, 0, 0, 0, 0, 0, 0, 0, 0, 0, 0, 1, 195, 195, 195, 195.0, 0.0, 38025.0
0, 0, 0, 0, 0, 0, 0, 0, 0, 0, 0, 0, 0, 0, 0, 0, 0, 0, 0, 0, 0, 0, 0, 0, 0, 0, 0
0, 0, 1, 195, 195, 195, 195.0, 0.0, 38025.0, 0, 0, 0, 0, 0, 0, 0, 0, 0, 0, 0, 1, 195, 195, 195, 195.0, 0.0, 38025.0
2, 104, 0, 0, 0, 0, 0, 0, 0, 2, 104, 0, 0, 0, 0, 0, 0, 0, 4, 208, 0, 0, 0, 0, 0, 0, 0
0, 0, 0, 0, 0, 0, 0, 0, 0, 0, 0, 0, 0, 0, 0, 0, 0, 0, 0, 0, 0, 0, 0, 0, 0, 0, 0
26, 1352, 2, 772, 195, 577, 386.0, 36481.0, 185477.0, 0, 0, 77, 675524, 269, 18876, 8773.038961038961, 46072410.3491314, 123038622.96103896, 26, 1352, 79, 676296, 195, 18876, 8560.708860759494, 46372470.18573307, 119928416.73417722
0, 0, 0, 0, 0, 0, 0, 0, 0, 0, 0, 0, 0, 0, 0, 0, 0, 0, 0, 0, 0, 0, 0, 0, 0, 0, 0
0, 0, 0, 0, 0, 0, 0, 0, 0, 0, 0, 0, 0, 0, 0, 0, 0, 0, 0, 0, 0, 0, 0, 0, 0, 0, 0
0, 0, 1, 195, 195, 195, 195.0, 0.0, 38025.0, 0, 0, 0, 0, 0, 0, 0, 0, 0, 0, 0, 1, 195, 195, 195, 195.0, 0.0, 38025.0
0, 0, 0, 0, 0, 0, 0, 0, 0, 0, 0, 0, 0, 0, 0, 0, 0, 0, 0, 0, 0, 0, 0, 0, 0, 0, 0
0, 0, 0, 0, 0, 0, 0, 0, 0, 0, 0, 0, 0, 0, 0, 0, 0, 0, 0, 0, 0, 0, 0, 0, 0, 0, 0
0, 0, 0, 0, 0, 0, 0, 0, 0, 0, 0, 0, 0, 0, 0, 0, 0, 0, 0, 0, 0, 0, 0, 0, 0, 0, 0
0, 0, 0, 0, 0, 0, 0, 0, 0, 0, 0, 0, 0, 0, 0, 0, 0, 0, 0, 0, 0, 0, 0, 0, 0, 0, 0
0, 0, 0, 0, 0, 0, 0, 0, 0, 0, 0, 0, 0, 0, 0, 0, 0, 0, 0, 0, 0, 0, 0, 0, 0, 0, 0
0, 0, 0, 0, 0, 0, 0, 0, 0, 0, 0, 0, 0, 0, 0, 0, 0, 0, 0, 0, 0, 0, 0, 0, 0, 0, 0
0, 0, 0, 0, 0, 0, 0, 0, 0, 0, 0, 0, 0, 0, 0, 0, 0, 0, 0, 0, 0, 0, 0, 0, 0, 0, 0
0, 0, 0, 0, 0, 0, 0, 0, 0, 0, 0, 0, 0, 0, 0, 0, 0, 0, 0, 0, 0, 0, 0, 0, 0, 0, 0
24, 1248, 1, 577, 577, 577, 577.0, 0.0, 332929.0, 0, 0, 73, 671829, 1500, 20324, 9203.13698630137, 44057111.981234744, 128754842.36986302, 24, 1248, 74, 672406, 577, 20324, 9086.567567567568, 44260152.35688834, 127019411.1081081
0, 0, 0, 0, 0, 0, 0, 0, 0, 0, 0, 0, 0, 0, 0, 0, 0, 0, 0, 0, 0, 0, 0, 0, 0, 0, 0
0, 0, 0, 0, 0, 0, 0, 0, 0, 0, 0, 0, 0, 0, 0, 0, 0, 0, 0, 0, 0, 0, 0, 0, 0, 0, 0
0, 0, 0, 0, 0, 0, 0, 0, 0, 0, 0, 0, 0, 0, 0, 0, 0, 0, 0, 0, 0, 0, 0, 0, 0, 0, 0
2, 104, 0, 0, 0, 0, 0, 0, 0, 1, 52, 1, 83, 83, 83, 83.0, 0.0, 6889.0, 3, 156, 1, 83, 83, 83, 83.0, 0.0, 6889.0
1, 52, 0, 0, 0, 0, 0, 0, 0, 1, 52, 2, 376, 83, 293, 188.0, 11025.0, 46369.0, 2, 104, 2, 376, 83, 293, 188.0, 11025.0, 46369.0
0, 0, 0, 0, 0, 0, 0, 0, 0, 0, 0, 0, 0, 0, 0, 0, 0, 0, 0, 0, 0, 0, 0, 0, 0, 0, 0
0, 0, 0, 0, 0, 0, 0, 0, 0, 0, 0, 0, 0, 0, 0, 0, 0, 0, 0, 0, 0, 0, 0, 0, 0, 0, 0
0, 0, 1, 68, 68, 68, 68.0, 0.0, 4624.0, 0, 0, 0, 0, 0, 0, 0, 0, 0, 0, 0, 1, 68, 68, 68, 68.0, 0.0, 4624.0
0, 0, 0, 0, 0, 0, 0, 0, 0, 0, 0, 0, 0, 0, 0, 0, 0, 0, 0, 0, 0, 0, 0, 0, 0, 0, 0
0, 0, 0, 0, 0, 0, 0, 0, 0, 0, 0, 0, 0, 0, 0, 0, 0, 0, 0, 0, 0, 0, 0, 0, 0, 0, 0
28, 1432, 2, 645, 68, 577, 322.5, 64770.25, 168776.5, 2, 104, 78, 751684, 83, 26116, 9636.97435897436, 68939779.20447074, 161811054.0, 30, 1536, 80, 752329, 68, 26116, 9404.1125, 69152262.78629225, 157769997.0625
0, 0, 0, 0, 0, 0, 0, 0, 0, 1, 52, 0, 0, 0, 0, 0, 0, 0, 1, 52, 0, 0, 0, 0, 0, 0, 0
0, 0, 0, 0, 0, 0, 0, 0, 0, 0, 0, 0, 0, 0, 0, 0, 0, 0, 0, 0, 0, 0, 0, 0, 0, 0, 0
0, 0, 0, 0, 0, 0, 0, 0, 0, 0, 0, 0, 0, 0, 0, 0, 0, 0, 0, 0, 0, 0, 0, 0, 0, 0, 0
1, 60, 0, 0, 0, 0, 0, 0, 0, 0, 0, 0, 0, 0, 0, 0, 0, 0, 1, 60, 0, 0, 0, 0, 0, 0, 0
2, 112, 2, 637, 68, 569, 318.5, 62750.25, 164192.5, 1, 60, 0, 0, 0, 0, 0, 0, 0, 3, 172, 2, 637, 68, 569, 318.5, 62750.25, 164192.5
2, 104, 3, 1461, 103, 789, 487.0, 81794.66666666667, 318963.6666666667, 1, 60, 1, 189, 189, 189, 189.0, 0.0, 35721.0, 3, 164, 4, 1650, 103, 789, 412.5, 70389.76000000001, 248153.0
2, 104, 1, 103, 103, 103, 103.0, 0.0, 10609.0, 1, 52, 2, 490, 189, 301, 245.0, 3136.0, 63161.0, 3, 156, 3, 593, 103, 301, 197.66666666666666, 5735.039999999999, 45643.666666666664
0, 0, 0, 0, 0, 0, 0, 0, 0, 1, 52, 0, 0, 0, 0, 0, 0, 0, 1, 52, 0, 0, 0, 0, 0, 0, 0
0, 0, 0, 0, 0, 0, 0, 0, 0, 0, 0, 0, 0, 0, 0, 0, 0, 0, 0, 0, 0, 0, 0, 0, 0, 0, 0
0, 0, 0, 0, 0, 0, 0, 0, 0, 0, 0, 0, 0, 0, 0, 0, 0, 0, 0, 0, 0, 0, 0, 0, 0, 0, 0
0, 0, 0, 0, 0, 0, 0, 0, 0, 0, 0, 0, 0, 0, 0, 0, 0, 0, 0, 0, 0, 0, 0, 0, 0, 0, 0
32, 1664, 1, 577, 577, 577, 577.0, 0.0, 332929.0, 1, 52, 105, 1085890, 1422, 29012, 10341.809523809523, 60810704.001814045, 167763728.22857141, 33, 1716, 106, 1086467, 577, 29012, 10249.688679245282, 60972262.76089936, 166184192.38679245
0, 0, 0, 0, 0, 0, 0, 0, 0, 0, 0, 0, 0, 0, 0, 0, 0, 0, 0, 0, 0, 0, 0, 0, 0, 0, 0
0, 0, 0, 0, 0, 0, 0, 0, 0, 0, 0, 0, 0, 0, 0, 0, 0, 0, 0, 0, 0, 0, 0, 0, 0, 0, 0
2, 104, 2, 728, 91, 637, 364.0, 74529.0, 207025.0, 1, 52, 2, 422, 91, 331, 211.0, 14400.0, 58921.0, 3, 156, 4, 1150, 91, 637, 287.5, 39645.0, 132973.0
0, 0, 0, 0, 0, 0, 0, 0, 0, 0, 0, 0, 0, 0, 0, 0, 0, 0, 0, 0, 0, 0, 0, 0, 0, 0, 0
0, 0, 0, 0, 0, 0, 0, 0, 0, 0, 0, 0, 0, 0, 0, 0, 0, 0, 0, 0, 0, 0, 0, 0, 0, 0, 0
0, 0, 0, 0, 0, 0, 0, 0, 0, 0, 0, 0, 0, 0, 0, 0, 0, 0, 0, 0, 0, 0, 0, 0, 0, 0, 0
0, 0, 0, 0, 0, 0, 0, 0, 0, 0, 0, 0, 0, 0, 0, 0, 0, 0, 0, 0, 0, 0, 0, 0, 0, 0, 0
0, 0, 0, 0, 0, 0, 0, 0, 0, 0, 0, 0, 0, 0, 0, 0, 0, 0, 0, 0, 0, 0, 0, 0, 0, 0, 0
0, 0, 0, 0, 0, 0, 0, 0, 0, 0, 0, 0, 0, 0, 0, 0, 0, 0, 0, 0, 0, 0, 0, 0, 0, 0, 0
0, 0, 0, 0, 0, 0, 0, 0, 0, 0, 0, 0, 0, 0, 0, 0, 0, 0, 0, 0, 0, 0, 0, 0, 0, 0, 0
40, 2080, 1, 577, 577, 577, 577.0, 0.0, 332929.0, 0, 0, 93, 1075452, 1385, 26116, 11564.0, 56603978.817204304, 190330074.8172043, 40, 2080, 94, 1076029, 577, 26116, 11447.117021276596, 56943362.02505076, 188308828.58510637
0, 0, 0, 0, 0, 0, 0, 0, 0, 0, 0, 0, 0, 0, 0, 0, 0, 0, 0, 0, 0, 0, 0, 0, 0, 0, 0
0, 0, 0, 0, 0, 0, 0, 0, 0, 0, 0, 0, 0, 0, 0, 0, 0, 0, 0, 0, 0, 0, 0, 0, 0, 0, 0
0, 0, 0, 0, 0, 0, 0, 0, 0, 0, 0, 0, 0, 0, 0, 0, 0, 0, 0, 0, 0, 0, 0, 0, 0, 0, 0
1, 52, 0, 0, 0, 0, 0, 0, 0, 1, 52, 0, 0, 0, 0, 0, 0, 0, 2, 104, 0, 0, 0, 0, 0, 0, 0
0, 0, 0, 0, 0, 0, 0, 0, 0, 0, 0, 0, 0, 0, 0, 0, 0, 0, 0, 0, 0, 0, 0, 0, 0, 0, 0
0, 0, 0, 0, 0, 0, 0, 0, 0, 0, 0, 0, 0, 0, 0, 0, 0, 0, 0, 0, 0, 0, 0, 0, 0, 0, 0
0, 0, 0, 0, 0, 0, 0, 0, 0, 0, 0, 0, 0, 0, 0, 0, 0, 0, 0, 0, 0, 0, 0, 0, 0, 0, 0
0, 0, 0, 0, 0, 0, 0, 0, 0, 0, 0, 0, 0, 0, 0, 0, 0, 0, 0, 0, 0, 0, 0, 0, 0, 0, 0
1, 52, 0, 0, 0, 0, 0, 0, 0, 1, 52, 0, 0, 0, 0, 0, 0, 0, 2, 104, 0, 0, 0, 0, 0, 0, 0
2, 104, 1, 577, 577, 577, 577.0, 0.0, 332929.0, 0, 0, 9, 66136, 1500, 17428, 7348.444444444444, 39969385.35802469, 93969021.1111111, 2, 104, 10, 66713, 577, 17428, 6671.3, 40152005.73407202, 84605411.9
60, 3120, 1, 577, 577, 577, 577.0, 0.0, 332929.0, 2, 104, 119, 1059046, 76, 22298, 8899.546218487394, 46839582.88651931, 126041505.7815126, 62, 3224, 120, 1059623, 76, 22298, 8830.191666666668, 46932199.547171794, 124993934.30833334
3, 156, 0, 0, 0, 0, 0, 0, 0, 1, 52, 3, 459, 83, 293, 153.0, 9800.0, 33209.0, 4, 208, 3, 459, 83, 293, 153.0, 9800.0, 33209.0
0, 0, 0, 0, 0, 0, 0, 0, 0, 0, 0, 0, 0, 0, 0, 0, 0, 0, 0, 0, 0, 0, 0, 0, 0, 0, 0
0, 0, 0, 0, 0, 0, 0, 0, 0, 0, 0, 0, 0, 0, 0, 0, 0, 0, 0, 0, 0, 0, 0, 0, 0, 0, 0
0, 0, 0, 0, 0, 0, 0, 0, 0, 0, 0, 0, 0, 0, 0, 0, 0, 0, 0, 0, 0, 0, 0, 0, 0, 0, 0
0, 0, 0, 0, 0, 0, 0, 0, 0, 0, 0, 0, 0, 0, 0, 0, 0, 0, 0, 0, 0, 0, 0, 0, 0, 0, 0
0, 0, 0, 0, 0, 0, 0, 0, 0, 0, 0, 0, 0, 0, 0, 0, 0, 0, 0, 0, 0, 0, 0, 0, 0, 0, 0
0, 0, 0, 0, 0, 0, 0, 0, 0, 0, 0, 0, 0, 0, 0, 0, 0, 0, 0, 0, 0, 0, 0, 0, 0, 0, 0
0, 0, 0, 0, 0, 0, 0, 0, 0, 0, 0, 0, 0, 0, 0, 0, 0, 0, 0, 0, 0, 0, 0, 0, 0, 0, 0
0, 0, 0, 0, 0, 0, 0, 0, 0, 0, 0, 0, 0, 0, 0, 0, 0, 0, 0, 0, 0, 0, 0, 0, 0, 0, 0
33, 1716, 3, 1354, 200, 577, 451.3333333333333, 31584.22222222223, 235286.0, 0, 0, 105, 1134296, 1285, 24668, 10802.819047619048, 57121647.348208606, 173822546.7238095, 33, 1716, 108, 1135650, 200, 24668, 10515.277777777777, 57805506.398509994, 169000678.37037036
0, 0, 0, 0, 0, 0, 0, 0, 0, 1, 52, 0, 0, 0, 0, 0, 0, 0, 1, 52, 0, 0, 0, 0, 0, 0, 0
1, 60, 0, 0, 0, 0, 0, 0, 0, 0, 0, 0, 0, 0, 0, 0, 0, 0, 1, 60, 0, 0, 0, 0, 0, 0, 0
3, 164, 3, 1338, 200, 569, 446.0, 30258.0, 229174.0, 2, 120, 0, 0, 0, 0, 0, 0, 0, 5, 284, 3, 1338, 200, 569, 446.0, 30258.0, 229174.0
2, 104, 3, 992, 103, 786, 330.6666666666667, 103664.22222222223, 213004.66666666666, 1, 52, 3, 679, 189, 301, 226.33333333333334, 2787.555555555555, 54014.333333333336, 3, 156, 6, 1671, 103, 786, 278.5, 38832.09876543209, 133509.5
1, 52, 0, 0, 0, 0, 0, 0, 0, 1, 52, 0, 0, 0, 0, 0, 0, 0, 2, 104, 0, 0, 0, 0, 0, 0, 0
0, 0, 1, 200, 200, 200, 200.0, 0.0, 40000.0, 0, 0, 0, 0, 0, 0, 0, 0, 0, 0, 0, 1, 200, 200, 200, 200.0, 0.0, 40000.0
0, 0, 0, 0, 0, 0, 0, 0, 0, 0, 0, 0, 0, 0, 0, 0, 0, 0, 0, 0, 0, 0, 0, 0, 0, 0, 0
0, 0, 0, 0, 0, 0, 0, 0, 0, 0, 0, 0, 0, 0, 0, 0, 0, 0, 0, 0, 0, 0, 0, 0, 0, 0, 0
0, 0, 1, 200, 200, 200, 200.0, 0.0, 40000.0, 0, 0, 0, 0, 0, 0, 0, 0, 0, 0, 0, 1, 200, 200, 200, 200.0, 0.0, 40000.0
0, 0, 0, 0, 0, 0, 0, 0, 0, 0, 0, 0, 0, 0, 0, 0, 0, 0, 0, 0, 0, 0, 0, 0, 0, 0, 0
0, 0, 0, 0, 0, 0, 0, 0, 0, 0, 0, 0, 0, 0, 0, 0, 0, 0, 0, 0, 0, 0, 0, 0, 0, 0, 0
48, 2496, 2, 1154, 577, 577, 577.0, 0.0, 332929.0, 0, 0, 94, 1044935, 1314, 23220, 11116.329787234043, 50641570.92315527, 174214358.8617021, 48, 2496, 96, 1046089, 577, 23220, 10896.760416666666, 51265430.55357341, 170591829.07291666
0, 0, 0, 0, 0, 0, 0, 0, 0, 0, 0, 0, 0, 0, 0, 0, 0, 0, 0, 0, 0, 0, 0, 0, 0, 0, 0
0, 0, 0, 0, 0, 0, 0, 0, 0, 0, 0, 0, 0, 0, 0, 0, 0, 0, 0, 0, 0, 0, 0, 0, 0, 0, 0
0, 0, 0, 0, 0, 0, 0, 0, 0, 0, 0, 0, 0, 0, 0, 0, 0, 0, 0, 0, 0, 0, 0, 0, 0, 0, 0
0, 0, 0, 0, 0, 0, 0, 0, 0, 0, 0, 0, 0, 0, 0, 0, 0, 0, 0, 0, 0, 0, 0, 0, 0, 0, 0
0, 0, 0, 0, 0, 0, 0, 0, 0, 0, 0, 0, 0, 0, 0, 0, 0, 0, 0, 0, 0, 0, 0, 0, 0, 0, 0
